aggregate_count_action::repo_id	aggregate_count_action::repo_name	aggregate_count_action::repo_url	aggregate_count_action::opened_count	aggregate_count_action::closed_count	aggregate_count_action::reopened_count	aggregate_count_action::total_actions_count
68	thin	https://github.com/macournoyer/thin	1	4	0	5
507	twitter	https://github.com/sferik/twitter	0	2	0	2
1734	aasm	https://github.com/aasm/aasm	1	0	0	1
2019	warbler	https://github.com/jruby/warbler	0	1	0	1
2747	maphilight	https://github.com/kemayo/maphilight	1	0	0	1
3314	spree	https://github.com/spree/spree	5	11	3	19
4016	limechat	https://github.com/psychs/limechat	2	0	0	2
4828	acts-as-taggable-on	https://github.com/mbleigh/acts-as-taggable-on	1	0	0	1
6094	rufus-scheduler	https://github.com/jmettraux/rufus-scheduler	1	2	0	3
8393	paperclip	https://github.com/thoughtbot/paperclip	1	0	0	1
8514	rails	https://github.com/rails/rails	7	3	0	10
9370	ruby-processing	https://github.com/jashkenas/ruby-processing	0	6	0	6
10865	friendly_id	https://github.com/norman/friendly_id	1	0	0	1
11598	active_shipping	https://github.com/Shopify/active_shipping	1	0	0	1
20724	neo4j	https://github.com/andreasronge/neo4j	1	0	0	1
21099	scala-maven-plugin	https://github.com/davidB/scala-maven-plugin	0	1	0	1
23892	pianobar	https://github.com/PromyLOPh/pianobar	1	0	0	1
24053	configatron	https://github.com/markbates/configatron	1	0	0	1
33945	nokogiri	https://github.com/sparklemotion/nokogiri	1	1	0	2
34465	vim-ruby	https://github.com/vim-ruby/vim-ruby	0	2	0	2
35649	freeradius-server	https://github.com/FreeRADIUS/freeradius-server	1	1	0	2
37399	code_swarm	https://github.com/rictic/code_swarm	1	0	0	1
37997	httparty	https://github.com/jnunemaker/httparty	1	0	0	1
38708	http_accept_language	https://github.com/iain/http_accept_language	0	1	0	1
40559	gibberish-aes	https://github.com/mdp/gibberish-aes	0	1	0	1
42626	declarative_authorization	https://github.com/stffn/declarative_authorization	1	0	0	1
47476	qtile	https://github.com/qtile/qtile	1	1	0	2
49515	reek	https://github.com/troessner/reek	0	1	0	1
51480	vim-surround	https://github.com/tpope/vim-surround	0	1	0	1
52116	oscurrency	https://github.com/oscurrency/oscurrency	6	0	0	6
52287	delayed_job	https://github.com/collectiveidea/delayed_job	1	1	0	2
56125	clearance	https://github.com/thoughtbot/clearance	1	0	0	1
59180	jdeb	https://github.com/tcurdt/jdeb	1	0	0	1
65252	jekyll	https://github.com/mojombo/jekyll	1	2	0	3
66801	publify	https://github.com/fdv/publify	11	0	0	11
68626	nitrogen	https://github.com/nitrogen/nitrogen	1	0	0	1
71972	jquery_lazyload	https://github.com/tuupola/jquery_lazyload	0	1	0	1
75731	Dist-Zilla	https://github.com/rjbs/Dist-Zilla	1	0	0	1
84822	js-beautify	https://github.com/einars/js-beautify	0	1	0	1
85424	django-pagination	https://github.com/ericflo/django-pagination	1	0	0	1
85670	yui3	https://github.com/yui/yui3	0	1	0	1
86149	fitnesse	https://github.com/unclebob/fitnesse	2	0	0	2
90981	twitter	https://github.com/sixohsix/twitter	1	0	0	1
95560	standalone-migrations	https://github.com/thuss/standalone-migrations	1	0	0	1
97752	OmniGroup	https://github.com/omnigroup/OmniGroup	1	0	0	1
108695	jbrowse	https://github.com/GMOD/jbrowse	1	0	0	1
109788	enlive	https://github.com/cgrand/enlive	2	1	0	3
114732	form	https://github.com/malsup/form	1	0	0	1
117148	django-media-bundler	https://github.com/rnk/django-media-bundler	1	0	0	1
122044	machine.specifications	https://github.com/machine/machine.specifications	1	1	0	2
130065	pwman3	https://github.com/pwman3/pwman3	0	1	1	2
130473	simplecart-js	https://github.com/wojodesign/simplecart-js	1	0	0	1
140252	ack	https://github.com/petdance/ack	1	1	0	2
143580	django-cms	https://github.com/divio/django-cms	1	0	0	1
145744	flapjack	https://github.com/flpjck/flapjack	1	0	0	1
146982	grackle	https://github.com/hayesdavis/grackle	1	0	0	1
148903	incanter	https://github.com/liebke/incanter	1	0	0	1
152074	lanmap2	https://github.com/rflynn/lanmap2	1	0	0	1
153204	heroku	https://github.com/heroku/heroku	1	0	0	1
154520	vraptor	https://github.com/caelum/vraptor	0	1	0	1
156018	redis	https://github.com/antirez/redis	3	0	0	3
164151	browsercms	https://github.com/browsermedia/browsercms	1	2	0	3
168370	jruby	https://github.com/jruby/jruby	3	0	0	3
174881	ai-stager	https://github.com/aiaio/ai-stager	1	0	0	1
178300	ocra	https://github.com/larsch/ocra	1	0	0	1
183502	nosedjango	https://github.com/nosedjango/nosedjango	1	2	0	3
184460	celery	https://github.com/celery/celery	3	1	0	4
187863	maruku	https://github.com/bhollis/maruku	1	0	0	1
188029	hg-git	https://github.com/schacon/hg-git	1	0	0	1
194858	company-mode	https://github.com/company-mode/company-mode	0	1	0	1
196020	bucardo	https://github.com/bucardo/bucardo	1	0	0	1
198717	shimmie2	https://github.com/shish/shimmie2	1	0	0	1
198798	Ushahidi_Web	https://github.com/ushahidi/Ushahidi_Web	0	1	0	1
206084	homebrew	https://github.com/mxcl/homebrew	7	13	0	20
207190	xkcd-Bucket	https://github.com/zigdon/xkcd-Bucket	1	0	0	1
211588	paper_trail	https://github.com/airblade/paper_trail	1	0	0	1
211666	node	https://github.com/joyent/node	0	2	1	3
214175	Roundcube-Plugin-SieveRules-Managesieve	https://github.com/JohnDoh/Roundcube-Plugin-SieveRules-Managesieve	1	1	0	2
214710	scalatra	https://github.com/scalatra/scalatra	2	0	0	2
215047	MBProgressHUD	https://github.com/jdg/MBProgressHUD	1	0	0	1
220418	ThinkUp	https://github.com/ginatrapani/ThinkUp	0	3	0	3
221032	rock	https://github.com/nddrylliog/rock	0	1	0	1
221352	uniform	https://github.com/pixelmatrix/uniform	1	0	0	1
221386	vimproc.vim	https://github.com/Shougo/vimproc.vim	0	1	0	1
224942	django-authority	https://github.com/jezdez/django-authority	1	0	0	1
231339	net-ssh	https://github.com/net-ssh/net-ssh	1	0	0	1
232155	Simple-Comic	https://github.com/arauchfuss/Simple-Comic	1	0	0	1
232390	Garden	https://github.com/vanillaforums/Garden	1	0	0	1
237159	express	https://github.com/visionmedia/express	2	9	0	11
238983	rspec-mocks	https://github.com/rspec/rspec-mocks	1	1	0	2
241560	savon	https://github.com/savonrb/savon	1	0	0	1
242104	AJAX-Chat	https://github.com/Frug/AJAX-Chat	1	0	0	1
242950	app-termcast	https://github.com/doy/app-termcast	0	1	0	1
248409	gtd	https://github.com/radicaldesigns/gtd	1	0	0	1
250052	django-blog-zinnia	https://github.com/Fantomas42/django-blog-zinnia	0	1	0	1
253476	nanoc	https://github.com/nanoc/nanoc	1	0	0	1
255215	bfb	https://github.com/billiob/bfb	0	1	0	1
255478	orbeon-forms	https://github.com/orbeon/orbeon-forms	3	2	0	5
261943	middleman	https://github.com/middleman/middleman	2	1	0	3
266006	pylibmc	https://github.com/lericson/pylibmc	1	1	0	2
266926	xjst	https://github.com/veged/xjst	0	2	0	2
267009	Ruby-Graphviz	https://github.com/glejeune/Ruby-Graphviz	1	0	0	1
270054	ffi	https://github.com/ffi/ffi	1	0	0	1
279553	sbt	https://github.com/sbt/sbt	1	0	0	1
280749	redmine_backlogs	https://github.com/backlogs/redmine_backlogs	0	1	0	1
281414	remote_table	https://github.com/seamusabshere/remote_table	1	0	0	1
286066	rvm	https://github.com/wayneeseguin/rvm	1	2	0	3
286516	django-filer	https://github.com/stefanfoulis/django-filer	1	0	0	1
287842	bogart	https://github.com/nrstott/bogart	2	1	0	3
297058	inaturalist	https://github.com/inaturalist/inaturalist	2	1	0	3
299271	Elgg	https://github.com/Elgg/Elgg	2	1	0	3
299862	nltk	https://github.com/nltk/nltk	0	1	0	1
299972	parsley	https://github.com/cgrand/parsley	1	0	0	1
308770	devise	https://github.com/plataformatec/devise	1	0	0	1
309009	mongoid	https://github.com/mongoid/mongoid	3	2	1	6
312262	vimium	https://github.com/philc/vimium	1	0	0	1
312869	hadoop-lzo	https://github.com/twitter/hadoop-lzo	1	1	0	2
321278	npm	https://github.com/isaacs/npm	3	2	0	5
323683	django-nose	https://github.com/jbalogh/django-nose	1	0	0	1
326127	jquerytools	https://github.com/jquerytools/jquerytools	2	0	0	2
328597	nit	https://github.com/privat/nit	30	21	0	51
329390	Viewpoint	https://github.com/zenchild/Viewpoint	1	0	0	1
330275	Twig	https://github.com/fabpot/Twig	1	0	0	1
332509	scenejs	https://github.com/xeolabs/scenejs	0	1	0	1
335861	sparkup	https://github.com/rstacruz/sparkup	1	0	0	1
339567	ancestry	https://github.com/stefankroes/ancestry	2	1	0	3
341626	octopress	https://github.com/imathis/octopress	2	1	0	3
342681	Reel	https://github.com/pisi/Reel	1	0	0	1
344809	CopyQ	https://github.com/hluk/CopyQ	1	0	0	1
345337	openFrameworks	https://github.com/openframeworks/openFrameworks	3	2	0	5
349203	excon	https://github.com/geemus/excon	1	0	0	1
354455	marss	https://github.com/avadhpatel/marss	0	1	1	2
354843	jquery-maskmoney	https://github.com/plentz/jquery-maskmoney	1	0	0	1
356756	leiningen	https://github.com/technomancy/leiningen	1	0	0	1
357000	publicsuffix-ruby	https://github.com/weppos/publicsuffix-ruby	1	0	0	1
360086	git	https://github.com/msysgit/git	1	0	0	1
366720	erjang	https://github.com/trifork/erjang	1	0	0	1
374228	RestSharp	https://github.com/restsharp/RestSharp	1	16	0	17
374929	batteries-included	https://github.com/ocaml-batteries-team/batteries-included	1	0	0	1
375152	ojs	https://github.com/pkp/ojs	1	1	0	2
375388	cancan	https://github.com/ryanb/cancan	1	0	0	1
380961	masonry	https://github.com/desandro/masonry	1	1	0	2
382367	memc-nginx-module	https://github.com/agentzh/memc-nginx-module	1	0	0	1
390217	akvo-rsr	https://github.com/akvo/akvo-rsr	0	10	0	10
390622	entry_url_field	https://github.com/symphonists/entry_url_field	1	0	0	1
391515	freeseer	https://github.com/Freeseer/freeseer	2	2	0	4
393047	platform	https://github.com/cashmusic/platform	0	1	0	1
404319	rest-client	https://github.com/rest-client/rest-client	1	0	0	1
408601	web	https://github.com/hoisie/web	1	1	0	2
409101	django-taggit	https://github.com/alex/django-taggit	3	0	0	3
412126	devise_invitable	https://github.com/scambra/devise_invitable	2	2	0	4
422097	jenni	https://github.com/myano/jenni	1	0	0	1
434077	churn	https://github.com/danmayer/churn	0	1	0	1
436249	huBarcode	https://github.com/hudora/huBarcode	1	0	0	1
437011	zfs	https://github.com/zfsonlinux/zfs	2	0	0	2
440826	SlickGrid	https://github.com/mleibman/SlickGrid	3	0	0	3
441269	coffee-script	https://github.com/jashkenas/coffee-script	1	0	0	1
441854	markdown-js	https://github.com/evilstreak/markdown-js	1	0	0	1
447184	rspec-rails	https://github.com/rspec/rspec-rails	0	1	0	1
450241	python-docx	https://github.com/mikemaccana/python-docx	2	2	0	4
453037	CsvHelper	https://github.com/JoshClose/CsvHelper	0	1	0	1
455600	hiphop-php	https://github.com/facebook/hiphop-php	5	3	0	8
458058	symfony	https://github.com/symfony/symfony	3	2	0	5
459348	sms-backup-plus	https://github.com/jberkel/sms-backup-plus	1	0	0	1
460078	angular.js	https://github.com/angular/angular.js	6	3	1	10
462292	node-mongodb-native	https://github.com/mongodb/node-mongodb-native	1	0	0	1
466916	boost.m4	https://github.com/tsuna/boost.m4	1	0	0	1
467461	plupload	https://github.com/moxiecode/plupload	1	6	0	7
469830	signature-pad	https://github.com/thomasjbradley/signature-pad	0	4	0	4
471883	ImpressPages-CMS	https://github.com/impresspages/ImpressPages-CMS	1	1	0	2
473283	vimfiler.vim	https://github.com/Shougo/vimfiler.vim	1	1	0	2
473831	core	https://github.com/daitss/core	1	3	0	4
475598	PyTomCrypt	https://github.com/mikeboers/PyTomCrypt	1	6	1	8
476092	digital_cinema_tools	https://github.com/wolfgangw/digital_cinema_tools	0	1	0	1
478632	Stylish-Select	https://github.com/scottdarby/Stylish-Select	1	0	0	1
478804	writetothem	https://github.com/mysociety/writetothem	1	0	0	1
481220	vim-coffee-script	https://github.com/kchmck/vim-coffee-script	0	1	0	1
481872	vagrant	https://github.com/mitchellh/vagrant	6	4	0	10
487492	fixmystreet	https://github.com/mysociety/fixmystreet	1	0	0	1
488514	bundler	https://github.com/bundler/bundler	1	1	0	2
494068	cpp-netlib	https://github.com/cpp-netlib/cpp-netlib	2	6	0	8
501326	requirejs	https://github.com/jrburke/requirejs	2	0	0	2
502760	danbooru	https://github.com/r888888888/danbooru	2	1	0	3
506347	SquishIt	https://github.com/jetheredge/SquishIt	1	0	0	1
506837	ruby-readability	https://github.com/cantino/ruby-readability	1	0	0	1
507775	elasticsearch	https://github.com/elasticsearch/elasticsearch	7	6	0	13
508845	RestKit	https://github.com/RestKit/RestKit	1	1	0	2
512431	idiorm	https://github.com/j4mie/idiorm	1	0	0	1
513265	dyntype	https://github.com/mirage/dyntype	1	0	0	1
519620	hawtjni	https://github.com/fusesource/hawtjni	1	0	0	1
520178	migrations	https://github.com/CakeDC/migrations	0	1	0	1
521583	symfony-docs	https://github.com/symfony/symfony-docs	0	1	0	1
525734	cpanminus	https://github.com/miyagawa/cpanminus	1	1	0	2
527644	less.js	https://github.com/less/less.js	3	3	0	6
532252	documentjs	https://github.com/bitovi/documentjs	1	1	0	2
544208	ajenti	https://github.com/Eugeny/ajenti	1	2	0	3
544592	Monocle	https://github.com/joseph/Monocle	1	0	0	1
545751	SolrNet	https://github.com/mausch/SolrNet	18	0	0	18
545857	bane	https://github.com/danielwellman/bane	0	1	0	1
553641	TTTQuadrantControl	https://github.com/mattt/TTTQuadrantControl	1	0	0	1
553803	Penlight	https://github.com/stevedonovan/Penlight	1	1	0	2
557977	socket.io-client	https://github.com/LearnBoost/socket.io-client	1	0	0	1
557980	socket.io	https://github.com/LearnBoost/socket.io	1	0	0	1
559095	git-deploy	https://github.com/aizatto/git-deploy	1	0	0	1
560495	jsdoc	https://github.com/jsdoc3/jsdoc	0	2	0	2
561616	geddy	https://github.com/mde/geddy	1	0	0	1
561632	GearmanManager	https://github.com/brianlmoon/GearmanManager	1	0	0	1
561940	coffee-script-tmbundle	https://github.com/jashkenas/coffee-script-tmbundle	1	0	0	1
563197	naali	https://github.com/realXtend/naali	2	0	0	2
564599	uberon	https://github.com/obophenotype/uberon	2	2	0	4
571621	luarocks	https://github.com/keplerproject/luarocks	0	0	1	1
571770	pandoc	https://github.com/jgm/pandoc	1	0	0	1
574304	libPusher	https://github.com/lukeredpath/libPusher	1	4	0	5
576201	three.js	https://github.com/mrdoob/three.js	5	6	0	11
579738	askbot-devel	https://github.com/ASKBOT/askbot-devel	2	0	0	2
581456	gcontracts	https://github.com/andresteingress/gcontracts	0	1	0	1
581617	sag	https://github.com/sbisbee/sag	1	1	0	2
584410	django-tastypie	https://github.com/toastdriven/django-tastypie	1	0	0	1
584418	html5boilerplate.com	https://github.com/h5bp/html5boilerplate.com	1	1	0	2
587311	omniauth	https://github.com/intridea/omniauth	0	4	0	4
588896	php-zmq	https://github.com/mkoppanen/php-zmq	1	1	0	2
596711	fixmytransport	https://github.com/mysociety/fixmytransport	3	1	0	4
597879	mongoose	https://github.com/LearnBoost/mongoose	2	2	0	4
599070	sskeychain	https://github.com/soffes/sskeychain	2	2	0	4
599443	plr	https://github.com/jconway/plr	2	0	0	2
605459	hidapi	https://github.com/signal11/hidapi	0	3	0	3
606209	redmine_menu_links	https://github.com/Tide/redmine_menu_links	1	0	0	1
610866	jquery-ui-multiselect-widget	https://github.com/ehynds/jquery-ui-multiselect-widget	1	0	0	1
611921	active_admin	https://github.com/gregbell/active_admin	1	1	0	2
614070	rubygems	https://github.com/rubygems/rubygems	0	1	0	1
625346	cinch	https://github.com/cinchrb/cinch	2	1	1	4
628618	peg	https://github.com/pointlander/peg	1	0	0	1
633141	pusher_client_python	https://github.com/pusher/pusher_client_python	1	0	0	1
641512	openstreetmap-website	https://github.com/openstreetmap/openstreetmap-website	0	2	0	2
643909	devtools	https://github.com/hadley/devtools	1	1	1	3
647414	compmake	https://github.com/AndreaCensi/compmake	1	0	0	1
648332	assimp	https://github.com/assimp/assimp	0	1	0	1
648414	jquery-validation	https://github.com/jzaefferer/jquery-validation	1	0	0	1
654608	joblib	https://github.com/joblib/joblib	1	0	0	1
658518	ipython	https://github.com/ipython/ipython	2	0	0	2
660234	package-stash	https://github.com/doy/package-stash	1	1	0	2
662853	stellar	https://github.com/cbinding/stellar	1	0	0	1
667006	video.js	https://github.com/videojs/video.js	1	3	0	4
669174	DataTables	https://github.com/DataTables/DataTables	1	1	0	2
670034	jquery.simpleWeather	https://github.com/monkeecreate/jquery.simpleWeather	1	2	1	4
671825	graylog2-server	https://github.com/Graylog2/graylog2-server	1	1	0	2
675247	django-celery	https://github.com/celery/django-celery	1	0	0	1
682817	django-likes	https://github.com/praekelt/django-likes	2	0	0	2
685000	Beowulf---PAS	https://github.com/portableant/Beowulf---PAS	6	0	0	6
687157	django-sitetree	https://github.com/idlesign/django-sitetree	0	1	0	1
687836	connect	https://github.com/senchalabs/connect	1	1	0	2
688157	jQuery-Autocomplete	https://github.com/devbridge/jQuery-Autocomplete	0	1	0	1
689662	scct	https://github.com/mtkopone/scct	0	1	0	1
689949	VivaMVC	https://github.com/schnipseljagd/VivaMVC	0	2	0	2
692399	openvpn-mysql-auth	https://github.com/chantra/openvpn-mysql-auth	0	0	1	1
692528	mezzanine	https://github.com/stephenmcd/mezzanine	1	1	0	2
695461	django-fsm	https://github.com/kmmbvnr/django-fsm	1	0	0	1
698041	async	https://github.com/caolan/async	1	0	0	1
701765	geonode	https://github.com/GeoNode/geonode	3	1	0	4
702550	zf2	https://github.com/zendframework/zf2	1	0	0	1
704698	nt2	https://github.com/MetaScale/nt2	2	2	0	4
708684	cedar	https://github.com/pivotal/cedar	0	1	0	1
711976	node-github	https://github.com/mikedeboer/node-github	1	0	0	1
712006	server	https://github.com/ohmage/server	0	3	0	3
712530	fabric.js	https://github.com/kangax/fabric.js	0	1	0	1
713249	dist-zilla-plugin-githubmeta	https://github.com/bingos/dist-zilla-plugin-githubmeta	0	1	0	1
715547	highcharts.com	https://github.com/highslide-software/highcharts.com	2	1	1	4
718309	Kiwi	https://github.com/allending/Kiwi	1	0	0	1
718963	multi_json	https://github.com/intridea/multi_json	1	0	0	1
724712	rust	https://github.com/mozilla/rust	10	13	0	23
727219	seltzer	https://github.com/elplatt/seltzer	2	0	0	2
729379	nspages	https://github.com/gturri/nspages	0	1	0	1
734934	jade	https://github.com/visionmedia/jade	3	0	0	3
744834	shopqi	https://github.com/saberma/shopqi	1	0	0	1
745749	testng	https://github.com/cbeust/testng	1	0	0	1
748661	acts_as_api	https://github.com/fabrik42/acts_as_api	2	0	0	2
749137	atmosphere	https://github.com/Atmosphere/atmosphere	1	8	0	9
749491	mapwarper	https://github.com/timwaters/mapwarper	2	0	0	2
753297	jQuery-Timepicker-Addon	https://github.com/trentrichardson/jQuery-Timepicker-Addon	2	0	0	2
756967	gocode	https://github.com/nsf/gocode	0	1	0	1
757363	knockout	https://github.com/knockout/knockout	2	1	0	3
758079	tilemill	https://github.com/mapbox/tilemill	2	3	0	5
761438	baker	https://github.com/Simbul/baker	1	2	0	3
761653	phpDocumentor2	https://github.com/phpDocumentor/phpDocumentor2	0	1	0	1
763666	quicklisp-projects	https://github.com/quicklisp/quicklisp-projects	2	0	0	2
767761	kissy	https://github.com/kissyteam/kissy	1	0	0	1
769751	rubydoc.info	https://github.com/lsegal/rubydoc.info	1	1	0	2
771016	boto	https://github.com/boto/boto	1	2	0	3
773194	vrapper	https://github.com/vrapper/vrapper	2	0	0	2
775131	OpenColorIO	https://github.com/imageworks/OpenColorIO	1	0	0	1
775386	qTip2	https://github.com/qTip2/qTip2	1	1	0	2
779851	mozmill-dashboard	https://github.com/mozilla/mozmill-dashboard	1	0	0	1
779996	unite.vim	https://github.com/Shougo/unite.vim	2	2	0	4
780341	symphony-2	https://github.com/symphonycms/symphony-2	1	1	0	2
781544	core	https://github.com/zikula/core	5	6	0	11
782257	ols	https://github.com/jawi/ols	0	0	1	1
784744	poMMo	https://github.com/soonick/poMMo	0	1	0	1
785509	xitrum	https://github.com/ngocdaothanh/xitrum	6	3	0	9
790359	sequelize	https://github.com/sequelize/sequelize	0	1	0	1
790660	datamappify	https://github.com/fredwu/datamappify	1	1	1	3
790938	riak_core	https://github.com/basho/riak_core	8	0	0	8
791720	engine	https://github.com/locomotivecms/engine	1	2	2	5
792613	option-tree	https://github.com/valendesigns/option-tree	1	2	0	3
793799	SCSS.tmbundle	https://github.com/MarioRicalde/SCSS.tmbundle	1	0	0	1
796565	codeseed	https://github.com/utumdol/codeseed	2	1	0	3
799844	node-static	https://github.com/cloudhead/node-static	1	1	0	2
800115	underscore.string	https://github.com/epeli/underscore.string	0	2	0	2
801795	MagicalRecord	https://github.com/magicalpanda/MagicalRecord	0	1	0	1
802006	mediaelement	https://github.com/johndyer/mediaelement	1	0	0	1
804982	Studio100.bundle	https://github.com/plexinc-plugins/Studio100.bundle	1	0	0	1
806874	Content	https://github.com/zikula-modules/Content	1	0	0	1
806926	Scribite	https://github.com/zikula-modules/Scribite	1	1	0	2
812393	grape	https://github.com/intridea/grape	1	0	0	1
812610	guard	https://github.com/guard/guard	0	3	0	3
816295	NBT	https://github.com/twoolie/NBT	0	1	0	1
822025	couchdb-guide	https://github.com/oreilly/couchdb-guide	1	0	0	1
824567	iphone-backup	https://github.com/albertz/iphone-backup	1	0	0	1
827644	openslide	https://github.com/openslide/openslide	2	1	0	3
829093	NAppUpdate	https://github.com/synhershko/NAppUpdate	1	0	0	1
834586	whiteboard	https://github.com/professor/whiteboard	1	0	0	1
842037	Nimrod	https://github.com/Araq/Nimrod	1	0	0	1
842640	sbcl-win32-threads	https://github.com/akovalenko/sbcl-win32-threads	1	0	0	1
843222	scikit-learn	https://github.com/scikit-learn/scikit-learn	1	0	0	1
847744	dotliquid	https://github.com/formosatek/dotliquid	0	3	0	3
847885	MathJax	https://github.com/mathjax/MathJax	2	0	0	2
849182	ghcjs	https://github.com/ghcjs/ghcjs	5	3	0	8
849692	ssziparchive	https://github.com/soffes/ssziparchive	1	1	0	2
851431	nexus-ruby-support	https://github.com/sonatype/nexus-ruby-support	2	1	0	3
853327	simplenote.vim	https://github.com/mrtazz/simplenote.vim	1	0	0	1
855523	chromephp	https://github.com/ccampbell/chromephp	1	0	0	1
856493	overtone	https://github.com/overtone/overtone	1	0	0	1
856780	morse	https://github.com/morse-simulator/morse	2	2	0	4
858127	pandas	https://github.com/pydata/pandas	10	3	1	14
864806	el-get	https://github.com/dimitri/el-get	0	2	0	2
865311	utils	https://github.com/CakeDC/utils	0	1	0	1
865412	opentsdb	https://github.com/OpenTSDB/opentsdb	1	0	0	1
866611	json_builder	https://github.com/dewski/json_builder	1	0	0	1
867283	rails3-amf	https://github.com/warhammerkid/rails3-amf	1	1	0	2
867564	robolectric	https://github.com/robolectric/robolectric	2	0	0	2
877602	iqvoc	https://github.com/innoq/iqvoc	0	1	0	1
880770	puppetlabs-apache	https://github.com/puppetlabs/puppetlabs-apache	1	0	0	1
887025	q	https://github.com/kriskowal/q	1	0	0	1
888427	the-blue-alliance	https://github.com/gregmarra/the-blue-alliance	0	2	0	2
890842	NetworkPrograming	https://github.com/timtan/NetworkPrograming	1	0	0	1
892275	retrofit	https://github.com/square/retrofit	1	2	1	4
895848	Osclass	https://github.com/osclass/Osclass	3	1	0	4
899771	Tron	https://github.com/Yelp/Tron	1	0	0	1
901277	osgearth	https://github.com/gwaldron/osgearth	1	1	0	2
901662	libgit2	https://github.com/libgit2/libgit2	1	1	0	2
901663	rugged	https://github.com/libgit2/rugged	0	1	0	1
907410	jquery-mobile	https://github.com/jquery/jquery-mobile	2	1	0	3
908607	numpy	https://github.com/numpy/numpy	4	3	1	8
908893	node_redis	https://github.com/mranney/node_redis	1	0	0	1
909119	PartKeepr	https://github.com/partkeepr/PartKeepr	0	10	0	10
909164	PHP-DAVE-API	https://github.com/evantahler/PHP-DAVE-API	1	0	0	1
909666	cloud9	https://github.com/ajaxorg/cloud9	1	0	0	1
911765	diaspora	https://github.com/diaspora/diaspora	1	0	0	1
911980	tarantool	https://github.com/tarantool/tarantool	1	2	0	3
916981	soundswitch	https://github.com/dmwyatt/soundswitch	1	0	0	1
919161	Arduino	https://github.com/arduino/Arduino	3	1	0	4
924303	zepto	https://github.com/madrobby/zepto	1	0	0	1
926231	jquery.inputmask	https://github.com/RobinHerbots/jquery.inputmask	0	0	1	1
929845	sass	https://github.com/nex3/sass	3	0	0	3
931033	Validation	https://github.com/Respect/Validation	1	0	0	1
931039	node-browserify	https://github.com/substack/node-browserify	1	0	0	1
931135	Leaflet	https://github.com/Leaflet/Leaflet	3	0	0	3
933839	ruby-marc	https://github.com/ruby-marc/ruby-marc	0	1	0	1
935336	java-classmate	https://github.com/cowtowncoder/java-classmate	0	3	0	3
936343	social_stream	https://github.com/ging/social_stream	2	0	0	2
938556	Archipel	https://github.com/ArchipelProject/Archipel	2	0	0	2
940290	peercaststation	https://github.com/kumaryu/peercaststation	2	0	0	2
941114	phpdox	https://github.com/theseer/phpdox	1	0	0	1
942613	NEST	https://github.com/Mpdreamz/NEST	2	1	0	3
942903	forever	https://github.com/nodejitsu/forever	1	0	0	1
943149	d3	https://github.com/mbostock/d3	2	1	0	3
946503	enki	https://github.com/hlamer/enki	0	1	0	1
946739	itunes	https://github.com/dewski/itunes	1	1	0	2
948190	paris	https://github.com/j4mie/paris	1	1	0	2
951269	Ipa-Reader	https://github.com/schlu/Ipa-Reader	1	0	0	1
952189	backbone	https://github.com/jashkenas/backbone	1	1	0	2
952439	api	https://github.com/tripit/api	0	2	0	2
959090	guard-rspec	https://github.com/guard/guard-rspec	0	5	0	5
959680	barnyard2	https://github.com/firnsy/barnyard2	0	1	0	1
959908	OpenRA	https://github.com/OpenRA/OpenRA	0	1	0	1
960044	jrl-walkgen	https://github.com/jrl-umi3218/jrl-walkgen	0	2	0	2
960600	jsduck	https://github.com/senchalabs/jsduck	2	0	0	2
960602	users	https://github.com/StartupAPI/users	0	1	0	1
961693	bigshotgaming	https://github.com/bigshotgaming/bigshotgaming	0	1	0	1
962121	Helium	https://github.com/HeliumProject/Helium	0	1	0	1
962863	axiscommerce	https://github.com/axis/axiscommerce	1	0	0	1
966614	dgrid	https://github.com/SitePen/dgrid	1	1	1	3
975050	snorby	https://github.com/Snorby/snorby	1	0	0	1
976994	django-allauth	https://github.com/pennersr/django-allauth	1	3	0	4
977244	MacRuby	https://github.com/MacRuby/MacRuby	1	0	0	1
979480	peewee	https://github.com/coleifer/peewee	0	1	0	1
984742	mrjob	https://github.com/Yelp/mrjob	3	1	0	4
989981	eregex.vim	https://github.com/othree/eregex.vim	1	0	0	1
991475	node-postgres	https://github.com/brianc/node-postgres	1	1	0	2
993110	pelican	https://github.com/getpelican/pelican	1	2	0	3
994615	nginx-push-stream-module	https://github.com/wandenberg/nginx-push-stream-module	1	0	0	1
997338	werkzeug	https://github.com/mitsuhiko/werkzeug	1	0	0	1
1006145	GAJavaScript	https://github.com/newyankeecodeshop/GAJavaScript	2	1	0	3
1006445	Elastica	https://github.com/ruflin/Elastica	1	0	0	1
1021586	netmagis	https://github.com/pdav/netmagis	0	1	0	1
1025813	guard-coffeescript	https://github.com/netzpirat/guard-coffeescript	1	1	0	2
1030566	jquery-ui-touch-punch	https://github.com/furf/jquery-ui-touch-punch	1	0	0	1
1030602	tmk_keyboard	https://github.com/tmk/tmk_keyboard	1	1	0	2
1032167	python-iptables	https://github.com/ldx/python-iptables	0	1	0	1
1033271	gqrx	https://github.com/csete/gqrx	1	1	0	2
1033759	SimpleAmqpClient	https://github.com/alanxz/SimpleAmqpClient	2	1	0	3
1035235	userpagecreate	https://github.com/cosmocode/userpagecreate	1	0	0	1
1036189	snogray	https://github.com/snogglethorpe/snogray	4	0	0	4
1039013	SWADroid	https://github.com/Amab/SWADroid	1	0	0	1
1039456	vim-orgmode	https://github.com/jceb/vim-orgmode	1	1	0	2
1039520	youtube-dl	https://github.com/rg3/youtube-dl	3	4	0	7
1041516	collective.github.com	https://github.com/collective/collective.github.com	2	2	0	4
1044366	Tinyboard	https://github.com/savetheinternet/Tinyboard	2	2	0	4
1044473	django-multilingual-model	https://github.com/dokterbob/django-multilingual-model	1	0	0	1
1049088	openscad	https://github.com/openscad/openscad	0	1	0	1
1049095	kivy	https://github.com/kivy/kivy	1	0	0	1
1050245	pgrouting	https://github.com/pgRouting/pgrouting	3	3	0	6
1051998	doctest-haskell	https://github.com/sol/doctest-haskell	3	2	0	5
1052694	remotestorage.js	https://github.com/remotestorage/remotestorage.js	1	2	1	4
1053964	Rex	https://github.com/krimdomu/Rex	1	0	0	1
1056713	NServiceBus	https://github.com/Particular/NServiceBus	1	0	0	1
1057143	android-rss	https://github.com/ahorn/android-rss	1	1	0	2
1058103	Django-RPC	https://github.com/Alerion/Django-RPC	0	1	0	1
1059291	SonataMediaBundle	https://github.com/sonata-project/SonataMediaBundle	0	1	0	1
1063498	CamanJS	https://github.com/meltingice/CamanJS	2	1	0	3
1064563	netty	https://github.com/netty/netty	7	2	0	9
1066171	n2cms	https://github.com/n2cms/n2cms	3	1	0	4
1066321	StofDoctrineExtensionsBundle	https://github.com/stof/StofDoctrineExtensionsBundle	1	0	0	1
1079822	pykka	https://github.com/jodal/pykka	1	0	0	1
1081665	vumi	https://github.com/praekelt/vumi	2	0	0	2
1090329	should.js	https://github.com/visionmedia/should.js	0	1	0	1
1092114	oauth2-provider	https://github.com/songkick/oauth2-provider	0	1	0	1
1093060	OpenELEC.tv	https://github.com/OpenELEC/OpenELEC.tv	2	3	0	5
1093276	node-loggly	https://github.com/nodejitsu/node-loggly	1	0	0	1
1095208	powertac-server	https://github.com/powertac/powertac-server	0	1	1	2
1095228	SonataAdminBundle	https://github.com/sonata-project/SonataAdminBundle	1	1	0	2
1097589	spectral-workbench	https://github.com/jywarren/spectral-workbench	2	2	0	4
1103054	pylearn2	https://github.com/lisa-lab/pylearn2	1	0	0	1
1108112	zhang-shasha	https://github.com/timtadh/zhang-shasha	0	1	0	1
1110720	django-floppyforms	https://github.com/brutasse/django-floppyforms	2	0	0	2
1117948	bottleneck	https://github.com/kwgoodman/bottleneck	0	1	1	2
1124391	gradle-tomcat-plugin	https://github.com/bmuschko/gradle-tomcat-plugin	1	0	0	1
1125389	alaveteli	https://github.com/mysociety/alaveteli	5	0	0	5
1129010	jQuery-File-Upload	https://github.com/blueimp/jQuery-File-Upload	2	3	0	5
1129337	PC-Programs	https://github.com/scieloorg/PC-Programs	2	25	0	27
1129765	dragtable	https://github.com/akottr/dragtable	1	1	0	2
1135454	CefSharp	https://github.com/cefsharp/CefSharp	1	0	0	1
1136075	iscroll	https://github.com/cubiq/iscroll	1	0	0	1
1140976	xmobar	https://github.com/jaor/xmobar	1	0	0	1
1144741	jiralicious	https://github.com/jstewart/jiralicious	1	0	0	1
1145832	pry	https://github.com/pry/pry	1	1	1	3
1148945	Polycode	https://github.com/ivansafrin/Polycode	1	0	0	1
1151051	django-oscar	https://github.com/tangentlabs/django-oscar	1	0	0	1
1156803	ISAcreator	https://github.com/ISA-tools/ISAcreator	2	0	0	2
1162559	Android-PwdHash	https://github.com/phw/Android-PwdHash	0	1	0	1
1162709	fsharp	https://github.com/fsharp/fsharp	1	0	0	1
1170740	babel	https://github.com/mikrobi/babel	1	0	0	1
1173667	CAAT	https://github.com/hyperandroid/CAAT	1	0	0	1
1176073	Bookie	https://github.com/mitechie/Bookie	1	0	0	1
1181927	bitcoin	https://github.com/bitcoin/bitcoin	1	0	0	1
1183708	sniproxy	https://github.com/dlundquist/sniproxy	1	1	0	2
1193527	FOSUserBundle	https://github.com/FriendsOfSymfony/FOSUserBundle	3	0	0	3
1200050	phantomjs	https://github.com/ariya/phantomjs	2	0	0	2
1200728	mymysql	https://github.com/ziutek/mymysql	1	1	0	2
1201104	dynmap	https://github.com/webbukkit/dynmap	1	1	0	2
1201167	buddypress-docs	https://github.com/boonebgorges/buddypress-docs	1	0	0	1
1204412	TrinityCore	https://github.com/TrinityCore/TrinityCore	7	2	0	9
1205958	seajs	https://github.com/seajs/seajs	1	1	0	2
1206729	autopep8	https://github.com/hhatto/autopep8	4	1	0	5
1207060	ebib	https://github.com/joostkremers/ebib	1	1	0	2
1207300	statsd	https://github.com/etsy/statsd	1	0	0	1
1208824	quartznet	https://github.com/quartznet/quartznet	1	2	0	3
1214411	LooseLeaf	https://github.com/tnantoka/LooseLeaf	1	0	0	1
1219074	annotator	https://github.com/okfn/annotator	1	0	0	1
1220144	cloudprint	https://github.com/armooo/cloudprint	0	3	0	3
1227666	goliath	https://github.com/postrank-labs/goliath	1	1	0	2
1229101	hyde	https://github.com/hyde/hyde	2	0	0	2
1234714	elixir	https://github.com/elixir-lang/elixir	0	3	0	3
1235955	depage-forms	https://github.com/depage/depage-forms	1	0	0	1
1237874	OpenEyes	https://github.com/openeyes/OpenEyes	0	1	0	1
1238201	DTCoreText	https://github.com/Cocoanetics/DTCoreText	1	6	0	7
1238771	assetic	https://github.com/kriswallsmith/assetic	0	1	0	1
1239728	cubes	https://github.com/Stiivi/cubes	1	0	0	1
1251049	geppetto	https://github.com/cloudsmith/geppetto	2	1	0	3
1254218	socketstream	https://github.com/socketstream/socketstream	0	1	0	1
1254497	CodeMirror	https://github.com/marijnh/CodeMirror	1	2	0	3
1257783	JAABA	https://github.com/kristinbranson/JAABA	1	0	0	1
1262196	MKStoreKit	https://github.com/MugunthKumar/MKStoreKit	1	0	0	1
1266188	socialnetwork	https://github.com/neuralnw/socialnetwork	1	1	0	2
1266625	libpointmatcher	https://github.com/ethz-asl/libpointmatcher	1	0	0	1
1268608	FOSFacebookBundle	https://github.com/FriendsOfSymfony/FOSFacebookBundle	1	0	0	1
1268826	sailthru-ruby-client	https://github.com/sailthru/sailthru-ruby-client	0	1	0	1
1271571	mawida_app	https://github.com/francocatena/mawida_app	2	0	0	2
1271747	postgres-copy	https://github.com/diogob/postgres-copy	0	1	0	1
1272424	Nodemailer	https://github.com/andris9/Nodemailer	1	1	0	2
1272666	jshint	https://github.com/jshint/jshint	1	0	0	1
1277769	vcs	https://github.com/codeinn/vcs	1	0	0	1
1279730	clafer	https://github.com/gsdlab/clafer	1	0	0	1
1282541	batman	https://github.com/batmanjs/batman	1	0	0	1
1283503	request	https://github.com/mikeal/request	2	1	1	4
1286397	Warmshowers.org	https://github.com/rfay/Warmshowers.org	0	1	0	1
1287727	ceylon-spec	https://github.com/ceylon/ceylon-spec	2	1	0	3
1287859	ceylon-compiler	https://github.com/ceylon/ceylon-compiler	4	5	1	10
1295304	facs	https://github.com/SciLifeLab/facs	0	1	0	1
1295612	flot	https://github.com/flot/flot	1	0	0	1
1296894	caesar-web	https://github.com/uid/caesar-web	1	0	0	1
1297957	Glimpse	https://github.com/Glimpse/Glimpse	1	19	0	20
1299808	inline_forms	https://github.com/acesuares/inline_forms	1	0	0	1
1300192	Spoon-Knife	https://github.com/octocat/Spoon-Knife	1	0	0	1
1301584	mne-python	https://github.com/mne-tools/mne-python	1	0	0	1
1303125	ranked-model	https://github.com/mixonic/ranked-model	0	1	0	1
1305488	ack2	https://github.com/petdance/ack2	1	0	0	1
1307238	phpmd	https://github.com/phpmd/phpmd	1	0	0	1
1307476	sorcery	https://github.com/NoamB/sorcery	1	0	0	1
1314976	curl	https://github.com/cujojs/curl	1	0	0	1
1318740	django-rte	https://github.com/aino/django-rte	1	0	0	1
1322105	x3dom	https://github.com/x3dom/x3dom	0	1	0	1
1326816	node-querystring	https://github.com/visionmedia/node-querystring	0	1	0	1
1329729	iRate	https://github.com/nicklockwood/iRate	1	0	0	1
1333343	acquaman	https://github.com/acquaman/acquaman	1	4	4	9
1334170	Factions	https://github.com/MassiveCraft/Factions	1	1	0	2
1334232	django-stdimage	https://github.com/humanfromearth/django-stdimage	1	0	0	1
1334535	imageruby	https://github.com/tario/imageruby	1	1	0	2
1334821	CouchPotatoServer	https://github.com/RuudBurger/CouchPotatoServer	7	9	0	16
1336071	Giles	https://github.com/codereflection/Giles	1	0	0	1
1338813	paper.js	https://github.com/paperjs/paper.js	2	0	0	2
1339333	brubeck	https://github.com/j2labs/brubeck	1	0	0	1
1343653	angularjs.org	https://github.com/angular/angularjs.org	1	0	0	1
1344937	cram	https://github.com/cujojs/cram	1	0	0	1
1345163	RSEM	https://github.com/bli25wisc/RSEM	1	0	0	1
1347323	cocoon	https://github.com/nathanvda/cocoon	0	1	0	1
1348101	monad-par	https://github.com/simonmar/monad-par	0	1	0	1
1348170	ocaml-zmq	https://github.com/pdhborges/ocaml-zmq	1	0	0	1
1353110	json	https://github.com/trentm/json	1	0	0	1
1354219	library	https://github.com/beangle/library	1	5	0	6
1359837	PassHash	https://github.com/wijjo/PassHash	1	0	0	1
1360248	WindowsPowerShell	https://github.com/AnthonyMastrean/WindowsPowerShell	0	2	0	2
1362437	rotp	https://github.com/mdp/rotp	1	1	0	2
1362490	requests	https://github.com/kennethreitz/requests	2	1	0	3
1362497	wire	https://github.com/cujojs/wire	1	1	0	2
1367055	node-sqlite3	https://github.com/developmentseed/node-sqlite3	0	1	0	1
1369824	csso	https://github.com/css/csso	1	0	0	1
1370856	Gibberbot	https://github.com/guardianproject/Gibberbot	1	1	0	2
1374129	basex	https://github.com/BaseXdb/basex	0	1	0	1
1376101	cjdns	https://github.com/cjdelisle/cjdns	1	0	0	1
1376813	bluecherry-client	https://github.com/bluecherrydvr/bluecherry-client	1	0	0	1
1377424	rdfstore-js	https://github.com/antoniogarrote/rdfstore-js	2	0	0	2
1379774	exception_notification	https://github.com/smartinez87/exception_notification	0	2	0	2
1380117	lantern	https://github.com/getlantern/lantern	6	3	0	9
1381103	tg2	https://github.com/TurboGears/tg2	0	2	0	2
1381859	query_reviewer	https://github.com/nesquena/query_reviewer	1	0	0	1
1383170	nodegit	https://github.com/nodegit/nodegit	0	3	0	3
1384929	platform	https://github.com/proofpoint/platform	1	0	0	1
1385122	matplotlib	https://github.com/matplotlib/matplotlib	3	4	0	7
1387559	Awful.apk	https://github.com/Awful/Awful.apk	0	1	0	1
1388245	android-async-http	https://github.com/loopj/android-async-http	2	0	0	2
1388891	yumex	https://github.com/timlau/yumex	0	1	0	1
1389611	elasticsearch-setup	https://github.com/rgl/elasticsearch-setup	1	0	0	1
1390248	salt	https://github.com/saltstack/salt	3	8	0	11
1398323	qupzilla	https://github.com/QupZilla/qupzilla	2	0	0	2
1407970	post-thumbnail-editor	https://github.com/sewpafly/post-thumbnail-editor	1	0	0	1
1409095	chai	https://github.com/agoragames/chai	0	1	0	1
1409544	capybara-webkit	https://github.com/thoughtbot/capybara-webkit	0	2	0	2
1411404	The-Nature-of-Code	https://github.com/shiffman/The-Nature-of-Code	0	1	0	1
1418153	libchewing	https://github.com/chewing/libchewing	1	1	0	2
1418628	duo_unix	https://github.com/duosecurity/duo_unix	2	1	0	3
1418662	lua-mode	https://github.com/immerrr/lua-mode	0	1	0	1
1420493	travis-ci	https://github.com/travis-ci/travis-ci	3	0	0	3
1423812	localwiki	https://github.com/localwiki/localwiki	1	0	0	1
1424470	moment	https://github.com/moment/moment	1	0	0	1
1428040	TA	https://github.com/n3wm1nd/TA	1	0	0	1
1431547	django-rest-framework	https://github.com/tomchristie/django-rest-framework	2	0	0	2
1433223	tabulous	https://github.com/techiferous/tabulous	1	0	0	1
1436022	JSARToolKit	https://github.com/kig/JSARToolKit	1	0	0	1
1438007	Terasology	https://github.com/MovingBlocks/Terasology	0	2	0	2
1440092	openscholar	https://github.com/openscholar/openscholar	19	7	0	26
1442359	ruby-filewatch	https://github.com/jordansissel/ruby-filewatch	1	0	0	1
1442729	ionize	https://github.com/ionize/ionize	1	0	0	1
1446467	pip	https://github.com/pypa/pip	1	0	0	1
1449773	red	https://github.com/red/red	0	1	0	1
1450620	squert	https://github.com/int13h/squert	4	1	0	5
1451060	ActionBarSherlock	https://github.com/JakeWharton/ActionBarSherlock	0	1	0	1
1459059	Copula	https://github.com/CakePHP-Copula/Copula	1	0	0	1
1459821	pow	https://github.com/37signals/pow	1	0	0	1
1460175	ascii.io	https://github.com/sickill/ascii.io	1	0	0	1
1460385	scipy	https://github.com/scipy/scipy	1	7	0	8
1461381	berusky2	https://github.com/stransky/berusky2	2	0	0	2
1467246	gridx	https://github.com/oria/gridx	1	0	0	1
1473235	disco-dop	https://github.com/andreasvc/disco-dop	0	1	0	1
1473291	handbook	https://github.com/nodejitsu/handbook	1	0	0	1
1477472	yupe	https://github.com/yupe/yupe	0	6	0	6
1478016	amber	https://github.com/amber-smalltalk/amber	4	7	0	11
1478026	Snittlistan	https://github.com/dlidstrom/Snittlistan	1	0	0	1
1483572	Slatwall	https://github.com/ten24/Slatwall	2	1	0	3
1488139	thumbor	https://github.com/globocom/thumbor	1	0	0	1
1501776	url_title_to_entry_id.pi.ee_addon	https://github.com/ninefour/url_title_to_entry_id.pi.ee_addon	1	0	0	1
1506989	dexy	https://github.com/dexy/dexy	3	2	0	5
1506989	dexy	https://github.com/ananelson/dexy	1	1	0	2
1511584	crashmail	https://github.com/larsks/crashmail	1	0	0	1
1513777	puppetlabs-rabbitmq	https://github.com/puppetlabs/puppetlabs-rabbitmq	2	1	0	3
1519818	bridge_troll	https://github.com/railsbridge/bridge_troll	1	0	0	1
1524684	SFML	https://github.com/LaurentGomila/SFML	1	1	0	2
1525163	spray	https://github.com/spray/spray	2	2	0	4
1529160	etherpad-lite	https://github.com/ether/etherpad-lite	1	1	0	2
1530210	LaTeXTools	https://github.com/SublimeText/LaTeXTools	1	0	0	1
1530481	pkg	https://github.com/freebsd/pkg	1	1	0	2
1533058	blaskan	https://github.com/persand/blaskan	1	0	0	1
1533568	bempp	https://github.com/bempp/bempp	0	1	0	1
1541369	Bonfire	https://github.com/ci-bonfire/Bonfire	2	0	0	2
1541643	tasktracker	https://github.com/remomueller/tasktracker	4	0	0	4
1542219	jsdiff	https://github.com/kpdecker/jsdiff	1	0	0	1
1542908	remote_syslog_logger	https://github.com/papertrail/remote_syslog_logger	0	1	0	1
1543499	backbone-atlas	https://github.com/cubox/backbone-atlas	1	0	0	1
1543962	core	https://github.com/fuel/core	1	2	0	3
1546909	Multiverse-Core	https://github.com/Multiverse/Multiverse-Core	0	9	0	9
1546912	Multiverse-Portals	https://github.com/Multiverse/Multiverse-Portals	0	5	0	5
1546915	Multiverse-SignPortals	https://github.com/Multiverse/Multiverse-SignPortals	0	1	0	1
1547318	Sick-Beard	https://github.com/mr-orange/Sick-Beard	2	0	0	2
1549212	Caravan	https://github.com/bashi-bazouk/Caravan	1	0	0	1
1549516	gofer	https://github.com/mipearson/gofer	2	1	0	3
1549991	JLM	https://github.com/oster/JLM	2	1	0	3
1551431	PySurfer	https://github.com/nipy/PySurfer	1	1	0	2
1555094	shogun	https://github.com/shogun-toolbox/shogun	1	3	0	4
1555626	viso	https://github.com/cloudapp/viso	0	1	0	1
1559931	virtus	https://github.com/solnic/virtus	1	0	0	1
1563018	oil	https://github.com/fuel/oil	2	0	0	2
1563595	calipso	https://github.com/cliftonc/calipso	1	1	1	3
1565682	RSFUtil	https://github.com/rsf/RSFUtil	1	0	0	1
1570020	pods	https://github.com/pods-framework/pods	1	16	0	17
1572576	lildebi	https://github.com/guardianproject/lildebi	0	3	0	3
1572659	osate2-core	https://github.com/osate/osate2-core	1	2	1	4
1578548	browserid	https://github.com/mozilla/browserid	3	1	0	4
1578963	hs-cprng-aes	https://github.com/vincenthz/hs-cprng-aes	1	1	0	2
1579809	iCarousel	https://github.com/nicklockwood/iCarousel	1	1	0	2
1579990	MonoGame	https://github.com/mono/MonoGame	1	0	0	1
1582219	phpspec	https://github.com/phpspec/phpspec	1	1	0	2
1584506	jopt-simple	https://github.com/pholser/jopt-simple	0	1	0	1
1588366	Restler	https://github.com/Luracast/Restler	0	1	0	1
1590738	Saved-Password-Editor	https://github.com/ddawson/Saved-Password-Editor	1	1	0	2
1591413	cloudbiolinux	https://github.com/chapmanb/cloudbiolinux	1	0	0	1
1591828	squeel	https://github.com/ernie/squeel	1	1	0	2
1593731	fqrouter	https://github.com/fqrouter/fqrouter	0	2	0	2
1596895	FFFFind	https://github.com/danielsim/FFFFind	1	1	0	2
1596945	find-unnecessary-includes	https://github.com/pukkaone/find-unnecessary-includes	0	1	0	1
1597789	melonJS	https://github.com/melonjs/melonJS	1	0	0	1
1599397	avocado	https://github.com/cbmi/avocado	1	2	0	3
1600255	stomp	https://github.com/mikkka/stomp	0	1	0	1
1601157	multi-select	https://github.com/lou/multi-select	1	1	0	2
1604375	w2ui	https://github.com/vitmalina/w2ui	1	0	0	1
1610564	fuse	https://github.com/jboss-fuse/fuse	3	1	0	4
1614137	Rock-ChMS	https://github.com/SparkDevNetwork/Rock-ChMS	1	1	0	2
1614737	crypto	https://github.com/Gozala/crypto	1	0	0	1
1617268	trema	https://github.com/trema/trema	1	0	0	1
1622048	SuperLearner	https://github.com/ecpolley/SuperLearner	1	0	0	1
1625491	KeyRemap4MacBook	https://github.com/tekezo/KeyRemap4MacBook	0	1	0	1
1625986	jOOQ	https://github.com/jOOQ/jOOQ	6	4	0	10
1626780	PermissionsEx	https://github.com/PEXPlugins/PermissionsEx	4	4	0	8
1630833	metacpan-web	https://github.com/CPAN-API/metacpan-web	1	0	0	1
1643317	node-progress	https://github.com/visionmedia/node-progress	1	0	0	1
1644196	julia	https://github.com/JuliaLang/julia	7	2	0	9
1644480	vegas	https://github.com/jaysalvat/vegas	1	1	0	2
1645954	EasyNetQ	https://github.com/mikehadlow/EasyNetQ	0	3	0	3
1652784	Aeon-Nox	https://github.com/BigNoid/Aeon-Nox	0	1	0	1
1662291	MuraTranslations	https://github.com/blueriver/MuraTranslations	2	0	0	2
1663468	pdf.js	https://github.com/mozilla/pdf.js	0	2	0	2
1663937	Talk	https://github.com/zooniverse/Talk	1	0	0	1
1666502	asmack	https://github.com/Flowdalic/asmack	0	1	0	1
1666821	ProcessWire	https://github.com/ryancramerdesign/ProcessWire	1	3	0	4
1668879	MoparClassic	https://github.com/Lothy/MoparClassic	2	1	0	3
1673183	sumo-tests	https://github.com/mozilla/sumo-tests	1	0	0	1
1674585	taskwarrior-web	https://github.com/theunraveler/taskwarrior-web	1	1	0	2
1675455	vcsh	https://github.com/RichiH/vcsh	1	0	0	1
1683798	core	https://github.com/axr/core	2	0	0	2
1688596	laptop	https://github.com/thoughtbot/laptop	1	0	0	1
1690444	moodle-mod_choicegroup	https://github.com/ndunand/moodle-mod_choicegroup	0	1	0	1
1692758	FoOlSlide	https://github.com/FoolCode/FoOlSlide	1	1	0	2
1693079	scriptdev2	https://github.com/mangosR2/scriptdev2	1	1	0	2
1700621	normalize.css	https://github.com/necolas/normalize.css	0	1	0	1
1701384	ogs	https://github.com/ufz/ogs	1	0	0	1
1705960	spark	https://github.com/perwendel/spark	0	2	0	2
1711467	Kundera	https://github.com/impetus-opensource/Kundera	4	2	0	6
1719844	vines	https://github.com/negativecode/vines	0	1	0	1
1723225	khan-exercises	https://github.com/Khan/khan-exercises	642	11269	0	11911
1724807	simperium-android	https://github.com/Simperium/simperium-android	1	1	0	2
1725199	linguist	https://github.com/github/linguist	1	0	0	1
1725847	td	https://github.com/treasure-data/td	0	1	0	1
1734612	chocolatey	https://github.com/chocolatey/chocolatey	1	1	0	2
1735985	r.js	https://github.com/jrburke/r.js	1	0	0	1
1745305	contact-form-7-datepicker	https://github.com/relu/contact-form-7-datepicker	1	0	0	1
1751059	appchan-x	https://github.com/zixaphir/appchan-x	1	0	0	1
1755413	xhtml2pdf	https://github.com/chrisglass/xhtml2pdf	1	0	0	1
1757260	frontend	https://github.com/photo/frontend	2	0	0	2
1757833	heroku-buildpack-scala	https://github.com/heroku/heroku-buildpack-scala	1	0	0	1
1758625	rletters	https://github.com/cpence/rletters	3	0	0	3
1759841	gad	https://github.com/mgenov/gad	1	0	0	1
1760606	APYDataGridBundle	https://github.com/Abhoryo/APYDataGridBundle	0	1	0	1
1762028	BlocksKit	https://github.com/pandamonia/BlocksKit	1	1	0	2
1762076	jQuery-Watermark	https://github.com/marioestrada/jQuery-Watermark	1	0	0	1
1764724	closure_tree	https://github.com/mceachen/closure_tree	1	0	0	1
1768018	PlistCS	https://github.com/animetrics/PlistCS	1	0	0	1
1771751	open_municipio	https://github.com/openpolis/open_municipio	1	1	0	2
1775877	TICoreDataSync	https://github.com/nothirst/TICoreDataSync	2	0	0	2
1780853	maid	https://github.com/benjaminoakes/maid	0	1	0	1
1782227	lamson	https://github.com/zedshaw/lamson	1	0	0	1
1785194	Fire-Soft-Board-2	https://github.com/FSB/Fire-Soft-Board-2	0	1	0	1
1785911	powify	https://github.com/sethvargo/powify	0	1	0	1
1788680	vlc-qt	https://github.com/ntadej/vlc-qt	0	1	0	1
1789662	quartz-monitor	https://github.com/jamescookie/quartz-monitor	1	0	0	1
1790564	jquery-handsontable	https://github.com/warpech/jquery-handsontable	1	0	0	1
1791097	python-ebay	https://github.com/roopeshvaddepally/python-ebay	1	0	0	1
1792346	rspec_junit_formatter	https://github.com/sj26/rspec_junit_formatter	1	0	0	1
1794012	heroku-buildpack-ruby	https://github.com/heroku/heroku-buildpack-ruby	1	1	0	2
1794507	JUTE	https://github.com/zzo/JUTE	1	0	0	1
1795089	puppetlabs-java	https://github.com/puppetlabs/puppetlabs-java	1	0	0	1
1797235	i18n	https://github.com/turquoiseowl/i18n	0	1	0	1
1801829	ember.js	https://github.com/emberjs/ember.js	2	2	0	4
1804325	lsdrv	https://github.com/pturmel/lsdrv	1	0	0	1
1818200	ntwitter	https://github.com/AvianFlu/ntwitter	2	0	0	2
1819719	oraide	https://github.com/ddbeck/oraide	0	1	0	1
1822520	puppetlabs-apt	https://github.com/puppetlabs/puppetlabs-apt	1	0	0	1
1823764	EventEmitter2	https://github.com/hij1nx/EventEmitter2	2	0	0	2
1823891	subcut	https://github.com/dickwall/subcut	2	0	0	2
1824050	phonegap-facebook-plugin	https://github.com/phonegap/phonegap-facebook-plugin	1	0	0	1
1826128	gatling	https://github.com/excilys/gatling	5	5	0	10
1828795	AFNetworking	https://github.com/AFNetworking/AFNetworking	1	2	0	3
1831380	jarb	https://github.com/42BV/jarb	2	4	0	6
1834942	KIF	https://github.com/kif-framework/KIF	1	6	0	7
1835758	Eto	https://github.com/picoe/Eto	1	1	0	2
1838413	DoctrineCouchDBBundle	https://github.com/doctrine/DoctrineCouchDBBundle	0	1	1	2
1839648	infinite-ajax-scroll	https://github.com/webcreate/infinite-ajax-scroll	0	1	0	1
1840419	jsonview	https://github.com/bhollis/jsonview	1	0	0	1
1843992	django-pipeline	https://github.com/cyberdelia/django-pipeline	2	0	0	2
1844290	SublimeLinter	https://github.com/SublimeLinter/SublimeLinter	1	0	0	1
1847706	zotonic	https://github.com/zotonic/zotonic	3	1	0	4
1850177	gnome-shell-extensions-mediaplayer	https://github.com/eonpatapon/gnome-shell-extensions-mediaplayer	0	1	0	1
1851224	umongo	https://github.com/agirbal/umongo	1	0	0	1
1851486	activate	https://github.com/fwbrasil/activate	1	1	0	2
1853243	ijson	https://github.com/isagalaev/ijson	0	1	0	1
1856063	apl	https://github.com/ngn/apl	1	1	0	2
1861458	reveal.js	https://github.com/hakimel/reveal.js	2	2	0	4
1863329	laravel	https://github.com/laravel/laravel	2	1	0	3
1863424	RF24Network	https://github.com/maniacbug/RF24Network	1	0	0	1
1864049	goldendict	https://github.com/goldendict/goldendict	0	1	0	1
1864233	erpnext	https://github.com/webnotes/erpnext	2	0	0	2
1864363	composer	https://github.com/composer/composer	5	2	0	7
1867347	osxfuse	https://github.com/osxfuse/osxfuse	1	0	0	1
1871068	redaxo4	https://github.com/redaxo/redaxo4	1	0	0	1
1873841	onebusaway-android	https://github.com/OneBusAway/onebusaway-android	1	1	0	2
1873881	nutz	https://github.com/nutzam/nutz	0	1	0	1
1875712	newfies-dialer	https://github.com/Star2Billing/newfies-dialer	0	1	0	1
1878700	node-elasticsearch-client	https://github.com/phillro/node-elasticsearch-client	1	0	0	1
1879029	modman	https://github.com/colinmollenhour/modman	0	1	0	1
1881749	h5ai	https://github.com/lrsjng/h5ai	0	1	0	1
1883401	statedecoded	https://github.com/statedecoded/statedecoded	7	1	1	9
1884096	phpspec2	https://github.com/phpspec/phpspec2	0	1	0	1
1885141	MiniKeePass	https://github.com/MiniKeePass/MiniKeePass	1	0	0	1
1885237	statsmodels	https://github.com/statsmodels/statsmodels	2	0	0	2
1888540	possum	https://github.com/possum-software/possum	1	1	0	2
1889439	Gedit-WhiteSpace-Terminator	https://github.com/Kozea/Gedit-WhiteSpace-Terminator	1	0	0	1
1890336	image_preview	https://github.com/Solutions-Nitriques/image_preview	0	1	0	1
1890900	vesta	https://github.com/serghey-rodin/vesta	1	0	0	1
1897125	rotate-backups	https://github.com/adamfeuer/rotate-backups	1	1	0	2
1905633	website	https://github.com/axr/website	0	1	0	1
1905671	Open-Data-Catalog	https://github.com/azavea/Open-Data-Catalog	1	0	0	1
1909263	lua-pb	https://github.com/Neopallium/lua-pb	1	0	0	1
1909546	bbfs	https://github.com/bbfsdev/bbfs	0	1	0	1
1912076	Diamond	https://github.com/BrightcoveOS/Diamond	1	0	0	1
1912351	plone.app.event	https://github.com/plone/plone.app.event	0	1	1	2
1914329	gddo	https://github.com/garyburd/gddo	0	1	0	1
1916332	ofxPolyfit	https://github.com/elliotwoods/ofxPolyfit	1	1	0	2
1918677	fluentd	https://github.com/fluent/fluentd	1	5	0	6
1924980	yii-debug-toolbar	https://github.com/malyshev/yii-debug-toolbar	1	0	0	1
1925457	gpslogger	https://github.com/mendhak/gpslogger	1	0	0	1
1930054	netinstall	https://github.com/RobertCNelson/netinstall	1	0	0	1
1936391	mongojs	https://github.com/mafintosh/mongojs	1	0	0	1
1937340	ripple	https://github.com/DarthFubuMVC/ripple	1	0	0	1
1938350	cycle2	https://github.com/malsup/cycle2	3	0	0	3
1939769	kudu	https://github.com/projectkudu/kudu	3	1	0	4
1941267	CreativeGates	https://github.com/MassiveCraft/CreativeGates	1	1	0	2
1942140	ckeditor	https://github.com/galetahub/ckeditor	1	0	0	1
1946622	vumi-go	https://github.com/praekelt/vumi-go	4	0	0	4
1948341	OpenStreetMap.ru	https://github.com/ErshKUS/OpenStreetMap.ru	1	2	1	4
1948619	download-monitor	https://github.com/mikejolley/download-monitor	1	0	0	1
1950690	react.js	https://github.com/natedavisolds/react.js	1	0	0	1
1952150	flatit	https://github.com/headi/flatit	0	1	0	1
1955800	paperwork	https://github.com/jflesch/paperwork	0	1	0	1
1960782	OpenMDAO-Framework	https://github.com/OpenMDAO/OpenMDAO-Framework	0	2	0	2
1962219	cucumber-jvm	https://github.com/cucumber/cucumber-jvm	0	1	0	1
1965901	node-midi	https://github.com/justinlatimer/node-midi	1	0	0	1
1968215	Vim-R-plugin	https://github.com/jcfaria/Vim-R-plugin	2	1	0	3
1968364	Xit	https://github.com/Uncommon/Xit	1	0	0	1
1970902	EWF	https://github.com/EiffelWebFramework/EWF	1	1	0	2
1970980	libxml-to-js	https://github.com/SaltwaterC/libxml-to-js	1	1	0	2
1972808	MultiInv	https://github.com/Pluckerpluck/MultiInv	0	2	0	2
1979797	FreeRDP	https://github.com/FreeRDP/FreeRDP	2	0	0	2
1981382	Omeka	https://github.com/omeka/Omeka	1	0	0	1
1988853	Jokels	https://github.com/sylturner/Jokels	0	1	0	1
1989551	collusion	https://github.com/mozilla/collusion	5	4	0	9
1992836	nipster	https://github.com/eirikb/nipster	1	0	0	1
1994469	pombola	https://github.com/mysociety/pombola	4	4	0	8
1995501	GraphView	https://github.com/jjoe64/GraphView	5	4	0	9
1995601	odeint-v2	https://github.com/headmyshoulder/odeint-v2	0	1	0	1
1997520	iOS-Inspired-jQuery-Mobile-Theme	https://github.com/taitems/iOS-Inspired-jQuery-Mobile-Theme	1	0	0	1
1997671	zeroclickinfo-spice	https://github.com/duckduckgo/zeroclickinfo-spice	0	1	0	1
2002809	DynamicistToolKit	https://github.com/moorepants/DynamicistToolKit	2	0	0	2
2006157	widget_manager	https://github.com/ColdTrick/widget_manager	1	0	0	1
2006495	website	https://github.com/WormBase/website	2	4	0	6
2008133	sate-core	https://github.com/sate-dev/sate-core	1	1	0	2
2011294	nemerle	https://github.com/rsdn/nemerle	0	1	0	1
2011647	Rajawali	https://github.com/MasDennis/Rajawali	0	1	0	1
2014670	mock_redis	https://github.com/causes/mock_redis	1	2	0	3
2020033	Modifyworld	https://github.com/PEXPlugins/Modifyworld	1	0	0	1
2020599	coderay	https://github.com/rubychan/coderay	1	0	0	1
2023792	cryptocat	https://github.com/cryptocat/cryptocat	1	0	0	1
2027397	WP-Geo	https://github.com/benhuson/WP-Geo	1	0	0	1
2028724	cgeo	https://github.com/cgeo/cgeo	4	0	0	4
2031178	xchataqua	https://github.com/xchataqua/xchataqua	1	0	0	1
2031640	sensu	https://github.com/sensu/sensu	2	0	0	2
2034023	testem	https://github.com/airportyh/testem	1	2	0	3
2037608	Sugar	https://github.com/andrewplummer/Sugar	1	1	0	2
2040419	tiimagefilters	https://github.com/atsusy/tiimagefilters	1	0	0	1
2044029	astyanax	https://github.com/Netflix/astyanax	0	1	0	1
2046192	open-build-service	https://github.com/openSUSE/open-build-service	1	0	0	1
2048269	WCF	https://github.com/WoltLab/WCF	1	0	0	1
2049440	placeholder-augment	https://github.com/jethrolarson/placeholder-augment	2	1	0	3
2051452	ruby-gnome2	https://github.com/ruby-gnome2/ruby-gnome2	1	0	0	1
2053705	bulbs	https://github.com/espeed/bulbs	1	0	0	1
2055958	jquery.html5loader	https://github.com/GianlucaGuarini/jquery.html5loader	2	2	0	4
2056312	html2canvas	https://github.com/niklasvh/html2canvas	1	0	0	1
2064011	itsalltext	https://github.com/docwhat/itsalltext	1	0	0	1
2065352	site	https://github.com/lelylan/site	1	0	0	1
2066292	Patterns	https://github.com/Patternslib/Patterns	1	0	0	1
2067414	SCEditor	https://github.com/samclarke/SCEditor	0	4	0	4
2067636	twitter-conduit	https://github.com/himura/twitter-conduit	1	0	0	1
2073231	sabotage	https://github.com/rofl0r/sabotage	1	0	0	1
2074345	totalterminal	https://github.com/binaryage/totalterminal	3	0	0	3
2076627	BullshitBuzzer	https://github.com/garage314/BullshitBuzzer	0	1	0	1
2076660	china_region_fu	https://github.com/Xuhao/china_region_fu	1	1	0	2
2077847	zsh-completions	https://github.com/zsh-users/zsh-completions	1	0	0	1
2078882	XChart	https://github.com/timmolter/XChart	1	0	0	1
2080877	collective.nitf	https://github.com/collective/collective.nitf	1	1	0	2
2081289	astropy	https://github.com/astropy/astropy	3	1	0	4
2087064	SignalR	https://github.com/SignalR/SignalR	2	0	0	2
2087405	sbt-xjc	https://github.com/sbt/sbt-xjc	1	0	0	1
2087868	NIPAP	https://github.com/SpriteLink/NIPAP	2	2	0	4
2090823	groovesharkControl	https://github.com/horejsek/groovesharkControl	0	6	0	6
2094490	spectrum	https://github.com/bgrins/spectrum	2	0	0	2
2098508	QLCoverFetcher	https://github.com/nagisa/QLCoverFetcher	2	0	0	2
2100090	check_mysql_query	https://github.com/phrawzty/check_mysql_query	2	0	0	2
2101031	flixel	https://github.com/HaxeFlixel/flixel	2	0	0	2
2105170	keysocket	https://github.com/borismus/keysocket	1	0	0	1
2109064	ccrtp	https://github.com/dyfet/ccrtp	1	0	0	1
2111095	atheme	https://github.com/atheme/atheme	2	0	0	2
2112231	TerrainControl	https://github.com/Wickth/TerrainControl	0	1	0	1
2117834	whisker	https://github.com/edwindj/whisker	1	0	0	1
2120546	Mathablix	https://github.com/garage314/Mathablix	1	0	0	1
2125451	GeoGit	https://github.com/opengeo/GeoGit	1	3	0	4
2126244	bootstrap	https://github.com/twbs/bootstrap	15	10	0	25
2126953	asset_sync	https://github.com/rumblelabs/asset_sync	1	0	0	1
2128582	ChuteSDKv2	https://github.com/chute/ChuteSDKv2	1	0	0	1
2130740	sublime_terminal	https://github.com/wbond/sublime_terminal	1	0	0	1
2134126	better-history	https://github.com/roykolak/better-history	0	2	0	2
2135514	node-youtube-dl	https://github.com/fent/node-youtube-dl	1	1	0	2
2141186	opencart	https://github.com/opencart/opencart	0	5	0	5
2142701	ruby-build	https://github.com/sstephenson/ruby-build	1	0	0	1
2144619	Propel	https://github.com/propelorm/Propel	1	2	0	3
2145468	nzmqt	https://github.com/jonnydee/nzmqt	2	2	0	4
2149604	ebaysdk-python	https://github.com/timotheus/ebaysdk-python	1	1	0	2
2154595	sublime_package_control	https://github.com/wbond/sublime_package_control	1	1	0	2
2156455	ceylon-ide-eclipse	https://github.com/ceylon/ceylon-ide-eclipse	6	3	0	9
2158982	querydsl	https://github.com/mysema/querydsl	3	0	0	3
2161177	WebWorks-Community-APIs	https://github.com/blackberry/WebWorks-Community-APIs	1	1	0	2
2161802	ImageLoader	https://github.com/novoda/ImageLoader	2	1	0	3
2163263	hapi	https://github.com/spumko/hapi	5	4	0	9
2164064	javascript.util	https://github.com/bjornharrtell/javascript.util	1	1	0	2
2164979	zeroclickinfo-goodies	https://github.com/duckduckgo/zeroclickinfo-goodies	0	1	0	1
2168780	minetest	https://github.com/minetest/minetest	0	3	0	3
2170516	KMMDroid	https://github.com/EABonney/KMMDroid	1	0	0	1
2173198	coolfluid3	https://github.com/coolfluid/coolfluid3	1	0	0	1
2175859	WebSocket-for-Python	https://github.com/Lawouach/WebSocket-for-Python	1	1	0	2
2179920	woocommerce	https://github.com/woothemes/woocommerce	5	7	1	13
2180736	NuGetGallery	https://github.com/NuGet/NuGetGallery	2	4	0	6
2188436	grainstore	https://github.com/Vizzuality/grainstore	1	1	0	2
2191449	aseba	https://github.com/aseba-community/aseba	1	2	0	3
2191777	sitepush	https://github.com/rowatt/sitepush	0	5	0	5
2195601	Off-the-Record-iOS	https://github.com/chrisballinger/Off-the-Record-iOS	3	1	0	4
2200003	MediaWiki-Bot	https://github.com/MediaWiki-Bot/MediaWiki-Bot	1	0	0	1
2200096	dubsar_android	https://github.com/jdee/dubsar_android	0	3	0	3
2201052	FlexSlider	https://github.com/woothemes/FlexSlider	1	0	0	1
2203645	CocoaPods	https://github.com/CocoaPods/CocoaPods	4	3	0	7
2212377	kimai	https://github.com/kimai/kimai	1	0	0	1
2212756	TiVo-Commander	https://github.com/arantius/TiVo-Commander	0	2	0	2
2217369	VanishNoPacket	https://github.com/mbax/VanishNoPacket	2	1	0	3
2218824	firephp-extension	https://github.com/firephp/firephp-extension	1	0	0	1
2222347	localeapp	https://github.com/Locale/localeapp	1	0	0	1
2234102	CodeIgniter	https://github.com/EllisLab/CodeIgniter	1	1	0	2
2236615	unisubs	https://github.com/pculture/unisubs	1	0	0	1
2237981	ethercalc	https://github.com/audreyt/ethercalc	2	1	0	3
2242185	event-stream	https://github.com/dominictarr/event-stream	1	0	0	1
2242510	td-logger-ruby	https://github.com/treasure-data/td-logger-ruby	1	0	0	1
2244067	awayphysics-core-fp11	https://github.com/away3d/awayphysics-core-fp11	0	1	0	1
2246709	robotframework-requests	https://github.com/bulkan/robotframework-requests	1	1	0	2
2252498	bonita	https://github.com/benwerd/bonita	1	0	0	1
2264945	logya	https://github.com/yaph/logya	1	3	0	4
2267438	Autogrow-Textarea	https://github.com/jevin/Autogrow-Textarea	1	0	0	1
2269193	Neatline	https://github.com/scholarslab/Neatline	0	2	1	3
2269868	rr	https://github.com/mozilla/rr	2	2	0	4
2271356	anima-character-generator	https://github.com/jmbowman/anima-character-generator	0	0	1	1
2273545	perlfaq	https://github.com/perl-doc-cats/perlfaq	0	1	0	1
2275588	maker	https://github.com/cage433/maker	0	6	0	6
2277989	jasmine-rails	https://github.com/searls/jasmine-rails	0	1	0	1
2278820	pry-rails	https://github.com/rweng/pry-rails	1	1	0	2
2279245	spree_admin_autocomplete	https://github.com/fabien/spree_admin_autocomplete	1	0	0	1
2280459	keymaster	https://github.com/madrobby/keymaster	1	0	0	1
2281177	GoSublime	https://github.com/DisposaBoy/GoSublime	0	2	0	2
2287388	seantis.reservation	https://github.com/seantis/seantis.reservation	0	2	0	2
2289859	grails-external-config-reload	https://github.com/adaptivecomputing/grails-external-config-reload	1	0	0	1
2299591	PHP-Download-Tracker	https://github.com/iNamik/PHP-Download-Tracker	1	0	0	1
2303340	basset	https://github.com/jasonlewis/basset	1	1	0	2
2304783	w3af	https://github.com/andresriancho/w3af	2	0	0	2
2309696	Slic3r	https://github.com/alexrj/Slic3r	2	0	0	2
2312977	SwitchHosts	https://github.com/oldj/SwitchHosts	1	0	0	1
2314534	pump.io	https://github.com/e14n/pump.io	2	0	0	2
2319846	grocery-crud	https://github.com/scoumbourdis/grocery-crud	1	0	0	1
2322382	Turntable-API	https://github.com/alaingilbert/Turntable-API	2	2	0	4
2323099	auth_googleoauth2	https://github.com/mouneyrac/auth_googleoauth2	4	5	0	9
2323960	yandex-music-mac-player	https://github.com/mblsha/yandex-music-mac-player	0	1	0	1
2324107	ShareKit	https://github.com/ShareKit/ShareKit	1	1	0	2
2325793	fabtools	https://github.com/ronnix/fabtools	0	1	0	1
2328523	casperjs	https://github.com/n1k0/casperjs	0	1	0	1
2329766	dotfiles	https://github.com/mathiasbynens/dotfiles	1	0	0	1
2331413	ctrlp.vim	https://github.com/kien/ctrlp.vim	1	1	0	2
2334426	groupscatalog2	https://github.com/Vinai/groupscatalog2	0	1	0	1
2334806	jrds	https://github.com/fbacchella/jrds	1	0	0	1
2335594	checkstyle-idea	https://github.com/jshiell/checkstyle-idea	1	0	0	1
2336578	bootstrap-sass	https://github.com/thomas-mcdonald/bootstrap-sass	0	1	0	1
2337256	vagrant-vbguest	https://github.com/dotless-de/vagrant-vbguest	1	0	0	1
2340549	playframework	https://github.com/playframework/playframework	4	3	0	7
2340891	Facete	https://github.com/GeoKnow/Facete	1	0	0	1
2341146	dunst	https://github.com/knopwob/dunst	1	0	0	1
2341342	vault	https://github.com/HeinrichApfelmus/vault	1	0	0	1
2343708	SdbNavigator	https://github.com/Reggino/SdbNavigator	1	0	0	1
2344720	clj-http	https://github.com/dakrone/clj-http	1	0	0	1
2345332	NeXT	https://github.com/modilabs/NeXT	0	1	0	1
2345629	websocketpp	https://github.com/zaphoyd/websocketpp	2	0	0	2
2347357	tornado-redis	https://github.com/leporo/tornado-redis	2	0	0	2
2350503	WISE-Portal	https://github.com/WISE-Community/WISE-Portal	1	1	0	2
2350771	WISE-VLE	https://github.com/WISE-Community/WISE-VLE	0	2	0	2
2360190	LesZindeps	https://github.com/LesZindeps/LesZindeps	1	1	0	2
2360755	wp-cli	https://github.com/wp-cli/wp-cli	2	1	0	3
2370458	WMCore	https://github.com/dmwm/WMCore	0	1	0	1
2386778	Idris-dev	https://github.com/edwinb/Idris-dev	1	0	0	1
2391782	SOLAS-Match	https://github.com/TheRosettaFoundation/SOLAS-Match	3	2	0	5
2392046	catalog	https://github.com/ubpb/catalog	2	2	0	4
2396674	nightingale-hacking	https://github.com/nightingale-media-player/nightingale-hacking	1	0	0	1
2401217	basho_docs	https://github.com/basho/basho_docs	1	0	0	1
2402668	flask-peewee	https://github.com/coleifer/flask-peewee	0	1	0	1
2403263	neobundle.vim	https://github.com/Shougo/neobundle.vim	1	0	0	1
2404027	storm	https://github.com/nathanmarz/storm	1	0	0	1
2407157	openlayers	https://github.com/openlayers/openlayers	1	0	0	1
2421610	Dollchan-Extension-Tools	https://github.com/SthephanShinkufag/Dollchan-Extension-Tools	1	1	0	2
2425099	Rebus	https://github.com/rebus-org/Rebus	0	1	0	1
2425597	Projectfork	https://github.com/projectfork/Projectfork	1	3	0	4
2425606	iFixitAndroid	https://github.com/iFixit/iFixitAndroid	1	0	0	1
2428356	community-plugins	https://github.com/xebialabs/community-plugins	1	0	0	1
2431108	arquillian.github.com	https://github.com/arquillian/arquillian.github.com	1	0	0	1
2431562	aprox	https://github.com/jdcasey/aprox	2	1	0	3
2435411	ido-ubiquitous	https://github.com/DarwinAwardWinner/ido-ubiquitous	1	0	0	1
2436444	cubeviz.ontowiki	https://github.com/AKSW/cubeviz.ontowiki	0	2	0	2
2437782	AChecker	https://github.com/atutor/AChecker	1	0	0	1
2441517	puma	https://github.com/puma/puma	2	10	0	12
2442469	JSONStream	https://github.com/dominictarr/JSONStream	1	1	0	2
2443905	monotony	https://github.com/aredington/monotony	2	1	0	3
2446011	on-screen-capture-recorder-to-video-windows-free	https://github.com/rdp/on-screen-capture-recorder-to-video-windows-free	1	0	0	1
2452776	diazo	https://github.com/plone/diazo	1	0	0	1
2455252	wp-photonav	https://github.com/fmos/wp-photonav	1	1	0	2
2456444	backbone.validation	https://github.com/thedersen/backbone.validation	1	0	0	1
2466605	SublimeREPL	https://github.com/wuub/SublimeREPL	1	1	0	2
2471281	trycatch	https://github.com/CrabDude/trycatch	0	2	0	2
2474428	suhosin	https://github.com/stefanesser/suhosin	0	1	0	1
2479778	Options-Framework	https://github.com/syamilmj/Options-Framework	1	2	0	3
2482127	RescueRails	https://github.com/ophrescue/RescueRails	1	1	0	2
2488436	Dancer2	https://github.com/PerlDancer/Dancer2	1	0	0	1
2488848	rdfbean	https://github.com/mysema/rdfbean	1	0	0	1
2491877	actionHero	https://github.com/evantahler/actionHero	2	3	0	5
2492312	wand	https://github.com/dahlia/wand	0	2	0	2
2492922	arcgis-viewer-flex	https://github.com/Esri/arcgis-viewer-flex	0	3	0	3
2493754	phantomjs-node	https://github.com/sgentle/phantomjs-node	1	1	0	2
2499845	lolcommits	https://github.com/mroth/lolcommits	2	1	0	3
2500088	gitlabhq	https://github.com/gitlabhq/gitlabhq	6	2	0	8
2500281	locomotive	https://github.com/jaredhanson/locomotive	1	0	0	1
2503263	Cupon	https://github.com/javiereguiluz/Cupon	0	1	0	1
2503899	CGP	https://github.com/pommi/CGP	2	0	0	2
2505739	mapstory	https://github.com/MapStory/mapstory	2	0	0	2
2505756	Stockfish	https://github.com/mcostalba/Stockfish	1	0	0	1
2508083	travis-build	https://github.com/travis-ci/travis-build	1	0	0	1
2508768	ceylon.language	https://github.com/ceylon/ceylon.language	0	1	0	1
2510495	nodejs-rpm	https://github.com/kazuhisya/nodejs-rpm	1	0	0	1
2511505	jsonform	https://github.com/joshfire/jsonform	0	2	0	2
2521861	saiku	https://github.com/OSBI/saiku	0	1	0	1
2522940	thorax	https://github.com/walmartlabs/thorax	1	0	0	1
2524005	http	https://github.com/tarcieri/http	2	1	0	3
2526596	meta-box	https://github.com/rilwis/meta-box	0	2	0	2
2528090	prelude	https://github.com/bbatsov/prelude	1	0	0	1
2531711	groan	https://github.com/mscdex/groan	1	1	0	2
2533836	UISS	https://github.com/robertwijas/UISS	0	1	0	1
2540870	MopaBootstrapBundle	https://github.com/phiamo/MopaBootstrapBundle	5	9	0	14
2541704	uwsgi	https://github.com/unbit/uwsgi	1	2	0	3
2544305	wiremock	https://github.com/tomakehurst/wiremock	1	0	0	1
2549826	voyeur	https://github.com/devthenet/voyeur	1	2	0	3
2550694	open311-mobile	https://github.com/City-of-Bloomington/open311-mobile	6	1	0	7
2556901	prefixfree	https://github.com/LeaVerou/prefixfree	1	0	0	1
2557003	gesundheit	https://github.com/BetSmartMedia/gesundheit	1	2	0	3
2557230	tower	https://github.com/tower/tower	0	1	0	1
2557743	pretty-diff	https://github.com/scottgonzalez/pretty-diff	0	1	0	1
2560978	Old_1.12_Bugtracker	https://github.com/FeenixServerProject/Old_1.12_Bugtracker	1	0	0	1
2560988	karma	https://github.com/karma-runner/karma	1	0	0	1
2562873	sleuthkit	https://github.com/sleuthkit/sleuthkit	2	0	0	2
2564641	irony-mode	https://github.com/Sarcasm/irony-mode	1	0	0	1
2565115	TP-data-games	https://github.com/serg-srri-umass/TP-data-games	3	1	0	4
2565137	spksrc	https://github.com/SynoCommunity/spksrc	2	0	0	2
2567844	qgroundcontrol	https://github.com/mavlink/qgroundcontrol	1	7	0	8
2573058	foundation	https://github.com/zurb/foundation	1	4	0	5
2574980	tcpcopy	https://github.com/wangbin579/tcpcopy	0	1	0	1
2584292	CameraFocus	https://github.com/joeonmars/CameraFocus	1	0	0	1
2584777	MahApps.Metro	https://github.com/MahApps/MahApps.Metro	4	1	0	5
2587997	app-parrot-create	https://github.com/letolabs/app-parrot-create	0	1	0	1
2592312	collective.cover	https://github.com/collective/collective.cover	1	1	0	2
2594513	knitr	https://github.com/yihui/knitr	1	0	0	1
2596658	passport-facebook	https://github.com/jaredhanson/passport-facebook	0	1	0	1
2601498	pomander	https://github.com/tamagokun/pomander	1	0	0	1
2602801	genmsg	https://github.com/ros/genmsg	1	0	0	1
2608629	PPQT	https://github.com/tallforasmurf/PPQT	0	3	0	3
2609298	suit	https://github.com/suitcss/suit	1	0	0	1
2616595	rickshaw	https://github.com/shutterstock/rickshaw	2	0	0	2
2620663	pulWifi	https://github.com/pulWifi/pulWifi	85	0	0	85
2622421	Starfall	https://github.com/GmodStarfall/Starfall	1	0	0	1
2624513	CareerVillage	https://github.com/jchubber/CareerVillage	1	0	0	1
2624521	gephi	https://github.com/gephi/gephi	2	0	0	2
2626317	fahrplan	https://github.com/smurfy/fahrplan	2	2	0	4
2626751	greenDAO	https://github.com/greenrobot/greenDAO	0	1	0	1
2629213	lparallel	https://github.com/lmj/lparallel	0	1	0	1
2636759	radium	https://github.com/kmatheussen/radium	1	2	0	3
2647332	scoobi	https://github.com/NICTA/scoobi	0	1	0	1
2649031	website	https://github.com/emberjs/website	2	1	0	3
2649781	Rammbock	https://github.com/robotframework/Rammbock	1	0	0	1
2651044	ANE-Flurry-Analytics	https://github.com/StickSports/ANE-Flurry-Analytics	1	0	0	1
2651634	stripe.net	https://github.com/jaymedavis/stripe.net	0	1	0	1
2651948	ariatemplates	https://github.com/ariatemplates/ariatemplates	1	0	0	1
2655877	postal.js	https://github.com/postaljs/postal.js	1	1	0	2
2656556	zotero	https://github.com/zotero/zotero	1	0	0	1
2658203	DeepLearnToolbox	https://github.com/rasmusbergpalm/DeepLearnToolbox	0	1	0	1
2662408	chef-cookbooks	https://github.com/rcbops/chef-cookbooks	1	2	0	3
2664389	Sublime-AdvancedNewFile	https://github.com/skuroda/Sublime-AdvancedNewFile	0	1	0	1
2665462	syslog-ng	https://github.com/algernon/syslog-ng	0	1	0	1
2667075	dma_elementgenerator	https://github.com/DMAGmbH/dma_elementgenerator	1	0	0	1
2677676	Mailpile	https://github.com/pagekite/Mailpile	0	3	0	3
2681135	AtlantissCore	https://github.com/Atlantiss/AtlantissCore	6	6	0	12
2681994	OpenID-Connect-Java-Spring-Server	https://github.com/mitreid-connect/OpenID-Connect-Java-Spring-Server	0	10	0	10
2685841	phenotips	https://github.com/phenotips/phenotips	1	2	0	3
2686160	Peergroup	https://github.com/smashnet/Peergroup	1	1	0	2
2688907	Reddit-Enhancement-Suite	https://github.com/honestbleeps/Reddit-Enhancement-Suite	0	1	0	1
2696306	Remmina	https://github.com/FreeRDP/Remmina	1	0	0	1
2698821	kujua-lite	https://github.com/medic/kujua-lite	8	1	0	9
2699859	twas	https://github.com/natevw/twas	1	0	0	1
2700159	druid	https://github.com/alibaba/druid	1	0	0	1
2700474	fastjson	https://github.com/alibaba/fastjson	1	0	0	1
2703613	umthesis	https://github.com/umasscs/umthesis	1	0	0	1
2705156	heroku-buildpack-go	https://github.com/kr/heroku-buildpack-go	1	0	0	1
2711548	pism	https://github.com/pism/pism	0	3	0	3
2715244	nvc	https://github.com/nickg/nvc	2	0	0	2
2715933	Baystation12	https://github.com/Baystation12/Baystation12	4	0	0	4
2717549	Sylius	https://github.com/Sylius/Sylius	1	0	0	1
2723178	plone.app.contenttypes	https://github.com/plone/plone.app.contenttypes	1	0	0	1
2724003	backbone.layoutmanager	https://github.com/tbranyen/backbone.layoutmanager	1	1	0	2
2724082	ec2instances.info	https://github.com/powdahound/ec2instances.info	0	1	0	1
2727089	reverie	https://github.com/milohuang/reverie	3	1	0	4
2728495	prestashop-fraktguide	https://github.com/nilsga/prestashop-fraktguide	1	0	0	1
2729639	Geocoder	https://github.com/geocoder-php/Geocoder	1	0	0	1
2731301	loomio	https://github.com/loomio/loomio	1	2	0	3
2734559	pyro_module_forums	https://github.com/semicolondevelopers/pyro_module_forums	1	1	0	2
2742529	ipcalc	https://github.com/tehmaze/ipcalc	1	0	0	1
2743221	iconv-lite	https://github.com/ashtuchkin/iconv-lite	1	0	0	1
2746528	jQuery-jSlots	https://github.com/matthewlein/jQuery-jSlots	1	0	0	1
2750721	ckan	https://github.com/okfn/ckan	4	2	0	6
2752123	django-mailchimp	https://github.com/piquadrat/django-mailchimp	1	0	0	1
2755696	go-sqlite3	https://github.com/mattn/go-sqlite3	1	1	0	2
2785239	nextbusjs	https://github.com/rf/nextbusjs	1	1	0	2
2786702	node-textspark	https://github.com/msiebuhr/node-textspark	0	1	0	1
2789846	Lift	https://github.com/croxis/Lift	0	2	1	3
2793055	Desurium	https://github.com/desura/Desurium	0	1	0	1
2793788	tidy-html5	https://github.com/w3c/tidy-html5	1	0	0	1
2794417	seelog	https://github.com/cihub/seelog	0	1	0	1
2796609	tilemill-builder-osx	https://github.com/mapbox/tilemill-builder-osx	1	0	0	1
2797951	DoctrineBundle	https://github.com/doctrine/DoctrineBundle	2	0	0	2
2799822	rfishbase	https://github.com/ropensci/rfishbase	0	4	0	4
2801094	scalikejdbc	https://github.com/seratch/scalikejdbc	2	0	0	2
2810455	the_silver_searcher	https://github.com/ggreer/the_silver_searcher	0	1	0	1
2812031	Pig	https://github.com/chrislongo/Pig	1	0	0	1
2812668	pybossa	https://github.com/PyBossa/pybossa	1	0	0	1
2813939	axlsx	https://github.com/randym/axlsx	1	0	0	1
2818521	FRC_align	https://github.com/vezzi/FRC_align	1	0	0	1
2818758	chrome	https://github.com/mywot/chrome	1	1	0	2
2820592	jtable	https://github.com/hikalkan/jtable	1	0	0	1
2823346	TimeSide	https://github.com/yomguy/TimeSide	0	0	1	1
2824114	ctypeslib	https://github.com/trolldbois/ctypeslib	5	0	0	5
2828239	TiddlyWiki5	https://github.com/Jermolene/TiddlyWiki5	1	0	0	1
2837141	apvs	https://github.com/CERN/apvs	14	5	0	19
2854337	cphalcon	https://github.com/phalcon/cphalcon	2	2	0	4
2854576	tosdr.org	https://github.com/tosdr/tosdr.org	0	1	0	1
2856799	bootstrap-sass-rails	https://github.com/yabawock/bootstrap-sass-rails	1	0	0	1
2857167	Tims-Chat	https://github.com/wbbaddons/Tims-Chat	1	0	0	1
2861008	cakephp-shopping-cart	https://github.com/andraskende/cakephp-shopping-cart	1	0	0	1
2861387	authenticate	https://github.com/yesodweb/authenticate	1	0	0	1
2863909	corrade	https://github.com/mosra/corrade	2	1	0	3
2875825	core	https://github.com/contao/core	5	3	0	8
2878641	system-rules	https://github.com/stefanbirkner/system-rules	1	0	0	1
2879796	vbench	https://github.com/pydata/vbench	1	0	0	1
2880469	Codeception	https://github.com/Codeception/Codeception	0	1	0	1
2883201	twit	https://github.com/ttezel/twit	1	0	0	1
2887215	github3	https://github.com/edwardhotchkiss/github3	1	1	0	2
2888090	Terasology	https://github.com/Nanoware/Terasology	1	2	0	3
2894555	VichUploaderBundle	https://github.com/dustin10/VichUploaderBundle	1	0	0	1
2895474	mate-file-manager	https://github.com/mate-desktop/mate-file-manager	1	0	0	1
2901410	android-visualizer	https://github.com/felixpalmer/android-visualizer	1	0	0	1
2909441	MongoDBI	https://github.com/alnewkirk/MongoDBI	0	2	0	2
2910598	PageTurner	https://github.com/NightWhistler/PageTurner	0	6	0	6
2915478	ViewDeck	https://github.com/Inferis/ViewDeck	1	0	0	1
2915603	platform	https://github.com/cassandra-project/platform	4	0	0	4
2916838	mozart2	https://github.com/mozart/mozart2	2	0	0	2
2918806	OpenRailwayMap	https://github.com/rurseekatze/OpenRailwayMap	1	0	0	1
2925127	ANTA	https://github.com/medialab/ANTA	1	0	0	1
2928520	Dancer-Plugin-LDAP	https://github.com/racke/Dancer-Plugin-LDAP	0	1	0	1
2928944	azure-sdk-for-net	https://github.com/WindowsAzure/azure-sdk-for-net	1	0	0	1
2933656	mcore	https://github.com/MassiveCraft/mcore	0	1	0	1
2933819	cairoplot	https://github.com/mrooney/cairoplot	1	0	0	1
2933939	PyAuthenNTLM2	https://github.com/Legrandin/PyAuthenNTLM2	0	1	0	1
2935735	brackets	https://github.com/adobe/brackets	5	10	0	15
2940708	MvcSiteMapProvider	https://github.com/maartenba/MvcSiteMapProvider	1	0	0	1
2942160	azure-sdk-tools	https://github.com/WindowsAzure/azure-sdk-tools	1	2	0	3
2942615	NineOldAndroids	https://github.com/JakeWharton/NineOldAndroids	1	1	0	2
2943728	liquid	https://github.com/acm-uiuc/liquid	1	1	0	2
2943911	montage	https://github.com/montagejs/montage	0	1	0	1
2944302	wiredtiger	https://github.com/wiredtiger/wiredtiger	3	2	0	5
2945088	revel	https://github.com/robfig/revel	2	2	0	4
2948037	pms-mlx	https://github.com/taconaut/pms-mlx	1	0	0	1
2948750	jquery-dnd-events	https://github.com/Cokegod/jquery-dnd-events	1	1	0	2
2948949	BroadleafCommerce	https://github.com/BroadleafCommerce/BroadleafCommerce	4	5	0	9
2950045	baseframe	https://github.com/hasgeek/baseframe	1	0	0	1
2959446	cookbook-elasticsearch	https://github.com/elasticsearch/cookbook-elasticsearch	1	0	0	1
2961951	boson-more	https://github.com/cldwalker/boson-more	1	0	0	1
2962804	Schweizer-Messer	https://github.com/furgalep/Schweizer-Messer	0	1	0	1
2966705	buildfarm	https://github.com/ros-infrastructure/buildfarm	1	0	0	1
2967472	ceylon-dist	https://github.com/ceylon/ceylon-dist	2	3	0	5
2967509	Wookmark-jQuery	https://github.com/GBKS/Wookmark-jQuery	1	0	0	1
2971394	Archangel_2.4.3_Bugtracker	https://github.com/FeenixServerProject/Archangel_2.4.3_Bugtracker	2	3	1	6
2972696	Cura	https://github.com/daid/Cura	1	1	0	2
2976082	Piranha	https://github.com/tidyui/Piranha	1	0	0	1
2982832	land_owner_tools	https://github.com/Ecotrust/land_owner_tools	1	0	0	1
2984039	CommonJobs	https://github.com/CommonJobs/CommonJobs	1	0	0	1
2990192	TextSecure	https://github.com/WhisperSystems/TextSecure	2	1	0	3
2992648	Open-Barcode	https://github.com/Floms/Open-Barcode	1	1	0	2
2994528	contao-haste	https://github.com/codefog/contao-haste	2	1	0	3
2994987	Goat	https://github.com/bcorrigan/Goat	1	7	0	8
2997880	Bumblebee	https://github.com/Bumblebee-Project/Bumblebee	0	1	0	1
2997935	iSENSE-Hardware	https://github.com/isenseDev/iSENSE-Hardware	1	0	0	1
2998320	compass-rails	https://github.com/Compass/compass-rails	1	0	0	1
2998811	CocoaHTTPServer	https://github.com/robbiehanson/CocoaHTTPServer	2	1	0	3
3004522	tapir	https://github.com/pentestify/tapir	1	0	0	1
3006455	shumway	https://github.com/mozilla/shumway	1	0	0	1
3013350	free-dom	https://github.com/asilano/free-dom	1	0	0	1
3016562	data	https://github.com/emberjs/data	3	13	1	17
3017189	kitten	https://github.com/evincarofautumn/kitten	4	0	0	4
3018212	genode	https://github.com/genodelabs/genode	1	0	0	1
3019537	Cinnamon	https://github.com/linuxmint/Cinnamon	1	1	0	2
3022431	backbone-fundamentals	https://github.com/addyosmani/backbone-fundamentals	1	0	0	1
3022773	PHP-Push-WebSocket	https://github.com/srchea/PHP-Push-WebSocket	1	0	0	1
3022931	node-oracle	https://github.com/nearinfinity/node-oracle	1	0	0	1
3026246	oxalis	https://github.com/difi/oxalis	1	0	0	1
3027949	appframework	https://github.com/01org/appframework	2	0	0	2
3029516	pip2pi	https://github.com/wolever/pip2pi	0	1	0	1
3034445	concrete5	https://github.com/concrete5japan/concrete5	0	1	0	1
3037564	mozmill-ci	https://github.com/mozilla/mozmill-ci	1	1	0	2
3038446	Pokemon-Showdown	https://github.com/Zarel/Pokemon-Showdown	1	1	0	2
3038937	jackson-databind	https://github.com/FasterXML/jackson-databind	0	1	0	1
3039185	QuoJS	https://github.com/soyjavi/QuoJS	2	0	0	2
3040675	geotrellis	https://github.com/geotrellis/geotrellis	0	5	0	5
3041962	core	https://github.com/isotope/core	2	3	0	5
3042666	LinkedHeritage	https://github.com/florent-andre/LinkedHeritage	2	43	0	45
3043179	jquery-indexeddb	https://github.com/axemclion/jquery-indexeddb	1	0	0	1
3044767	MJGFoundation	https://github.com/mattjgalloway/MJGFoundation	1	0	0	1
3049862	xmpp-client	https://github.com/agl/xmpp-client	1	0	0	1
3053417	SO-ChatBot	https://github.com/Zirak/SO-ChatBot	1	0	0	1
3055052	liquidsoap	https://github.com/savonet/liquidsoap	1	2	0	3
3055234	phinx	https://github.com/robmorgan/phinx	1	0	0	1
3056468	skylines	https://github.com/skylines-project/skylines	1	0	0	1
3057868	BeautifyRuby	https://github.com/CraigWilliams/BeautifyRuby	0	1	0	1
3066180	RapidEnv	https://github.com/bluemel/RapidEnv	1	0	0	1
3067051	lein-cljsbuild	https://github.com/emezeske/lein-cljsbuild	1	0	0	1
3070373	TeamPass	https://github.com/nilsteampassnet/TeamPass	0	1	1	2
3072250	DoctrineModule	https://github.com/doctrine/DoctrineModule	1	0	0	1
3076813	node-gyazo	https://github.com/ykzts/node-gyazo	2	0	0	2
3077654	ceylon-js	https://github.com/ceylon/ceylon-js	1	1	0	2
3080628	Fiona	https://github.com/Toblerity/Fiona	0	2	0	2
3084028	bash-functions	https://github.com/applemcg/bash-functions	0	1	0	1
3089935	volo	https://github.com/volojs/volo	1	0	0	1
3095618	jshint-eclipse	https://github.com/eclipsesource/jshint-eclipse	1	0	0	1
3100121	node-webkit	https://github.com/rogerwang/node-webkit	3	2	0	5
3101956	elephant.io	https://github.com/Wisembly/elephant.io	1	0	0	1
3102131	Wegas	https://github.com/Heigvd/Wegas	20	8	1	29
3102187	hanoidb	https://github.com/krestenkrab/hanoidb	1	0	0	1
3103654	HtmlSpanner	https://github.com/NightWhistler/HtmlSpanner	1	1	0	2
3104565	scilter	https://github.com/kayahr/scilter	1	0	0	1
3112411	mcMMO	https://github.com/mcMMO-Dev/mcMMO	6	5	0	11
3113319	mayocat-shop	https://github.com/mayocat/mayocat-shop	1	1	0	2
3114016	simple-json	https://github.com/facebook-csharp-sdk/simple-json	3	0	0	3
3116268	bootstrap_form	https://github.com/potenza/bootstrap_form	1	0	0	1
3116751	androidannotations	https://github.com/excilys/androidannotations	1	0	0	1
3119517	PyPDF2	https://github.com/mstamy2/PyPDF2	1	1	0	2
3119845	protos	https://github.com/derdesign/protos	1	0	0	1
3121188	torquebox-remote-deployer	https://github.com/jkutner/torquebox-remote-deployer	1	0	0	1
3122202	RxJS	https://github.com/Reactive-Extensions/RxJS	1	0	0	1
3130920	LaTeX-Box	https://github.com/LaTeX-Box-Team/LaTeX-Box	1	3	0	4
3132856	Haskell-Pipes-Library	https://github.com/Gabriel439/Haskell-Pipes-Library	1	1	0	2
3138420	cleeng-api-tutorials	https://github.com/Cleeng/cleeng-api-tutorials	1	0	0	1
3139032	WhirlyGlobe	https://github.com/mousebird/WhirlyGlobe	0	4	0	4
3139357	CSV-IATI-Converter	https://github.com/markbrough/CSV-IATI-Converter	0	1	0	1
3141834	ocaml-dns	https://github.com/avsm/ocaml-dns	0	1	0	1
3143966	toggle-readonly	https://github.com/reflog/toggle-readonly	1	0	0	1
3150560	icecast-kh	https://github.com/karlheyes/icecast-kh	1	0	0	1
3151841	TeXworks-scripts	https://github.com/henrikmidtiby/TeXworks-scripts	1	0	0	1
3157354	riak-ruby-client	https://github.com/basho/riak-ruby-client	0	1	1	2
3157404	makahiki	https://github.com/csdl/makahiki	0	1	0	1
3159351	woothee	https://github.com/tagomoris/woothee	1	1	0	2
3168452	Clubsite	https://github.com/OrienteerApp/Clubsite	6	0	0	6
3170207	grid	https://github.com/palasthotel/grid	4	5	0	9
3170740	katalogi	https://github.com/okffi/katalogi	1	0	0	1
3171106	ejabberd_tests	https://github.com/esl/ejabberd_tests	1	0	0	1
3173798	puppet-zypprepo	https://github.com/deadpoint/puppet-zypprepo	1	1	0	2
3180884	node-opencv	https://github.com/peterbraden/node-opencv	1	0	0	1
3190216	BeeHub	https://github.com/sara-nl/BeeHub	0	1	0	1
3193843	drush	https://github.com/drush-ops/drush	3	0	0	3
3195124	sidekiq	https://github.com/mperham/sidekiq	2	0	0	2
3196867	django-mutant	https://github.com/charettes/django-mutant	1	2	1	4
3197382	FileAPI	https://github.com/mailru/FileAPI	1	1	0	2
3199002	linux	https://github.com/raspberrypi/linux	2	2	0	4
3199627	HaTeX	https://github.com/Daniel-Diaz/HaTeX	1	0	0	1
3203524	KDGoalBar	https://github.com/donnellyk/KDGoalBar	1	0	0	1
3204140	sky	https://github.com/skydb/sky	1	1	0	2
3204386	Card-Game	https://github.com/shawn555444/Card-Game	1	0	0	1
3206704	QtDropbox	https://github.com/lycis/QtDropbox	1	0	0	1
3209649	doctrine1	https://github.com/drak/doctrine1	0	1	0	1
3210377	jappix	https://github.com/jappix/jappix	1	0	0	1
3210462	django-oauth2-provider	https://github.com/caffeinehit/django-oauth2-provider	1	0	0	1
3214406	meteor	https://github.com/meteor/meteor	1	0	0	1
3215654	owtf	https://github.com/7a/owtf	1	0	0	1
3217823	elasticsearch-analysis-stempel	https://github.com/elasticsearch/elasticsearch-analysis-stempel	1	0	0	1
3220120	CSV-IATI-Converter.modeleditor	https://github.com/markbrough/CSV-IATI-Converter.modeleditor	2	0	0	2
3222413	resume	https://github.com/Ceasar/resume	0	3	0	3
3222538	OCTGN	https://github.com/kellyelton/OCTGN	2	2	0	4
3222685	git-scripts	https://github.com/iFixit/git-scripts	1	1	0	2
3224614	cocos2d-html5	https://github.com/cocos2d/cocos2d-html5	0	1	0	1
3226512	simplesmtp	https://github.com/andris9/simplesmtp	0	1	0	1
3226746	OpenSearchResult	https://github.com/abrookins/OpenSearchResult	1	0	0	1
3228110	Unofficial-Google-Music-API	https://github.com/simon-weber/Unofficial-Google-Music-API	1	0	0	1
3229418	gwt-bootstrap	https://github.com/gwtbootstrap/gwt-bootstrap	1	0	0	1
3230766	BlockAlertsAnd-ActionSheets	https://github.com/gpambrozio/BlockAlertsAnd-ActionSheets	1	0	0	1
3231214	api-versions	https://github.com/erichmenge/api-versions	1	3	0	4
3234987	-tg-station	https://github.com/tgstation/-tg-station	1	1	0	2
3235645	chocolatey.org	https://github.com/chocolatey/chocolatey.org	1	0	0	1
3238587	LetMeWatchThis.bundle	https://github.com/ReallyFuzzy/LetMeWatchThis.bundle	1	0	0	1
3244052	puppet-network	https://github.com/adrienthebo/puppet-network	1	0	0	1
3244931	raven-php	https://github.com/getsentry/raven-php	1	0	0	1
3249713	fibrous	https://github.com/goodeggs/fibrous	0	1	0	1
3251639	aws-sdk-net	https://github.com/aws/aws-sdk-net	1	0	0	1
3251642	django-canadanewyork	https://github.com/saulshanabrook/django-canadanewyork	1	0	0	1
3257475	SMF2.1	https://github.com/SimpleMachines/SMF2.1	0	1	0	1
3260337	VSPlugin	https://github.com/blackberry/VSPlugin	4	0	0	4
3261210	nims	https://github.com/cni/nims	0	2	0	2
3261361	drupal-cookbook	https://github.com/promet/drupal-cookbook	1	0	0	1
3275365	spdylay	https://github.com/tatsuhiro-t/spdylay	0	0	1	1
3278888	runestone	https://github.com/bnmnetp/runestone	2	0	0	2
3283313	RoQ	https://github.com/roq-messaging/RoQ	2	2	0	4
3301400	MinecraftForge	https://github.com/MinecraftForge/MinecraftForge	1	1	0	2
3304447	elasticsearch-river-mongodb	https://github.com/richardwilly98/elasticsearch-river-mongodb	1	2	0	3
3308000	kate-cpp-helper-plugin	https://github.com/zaufi/kate-cpp-helper-plugin	1	1	0	2
3308958	cyclus	https://github.com/cyclus/cyclus	2	1	0	3
3313230	imeji	https://github.com/imeji-community/imeji	2	4	0	6
3314411	Rush	https://github.com/telefonicaid/Rush	1	1	0	2
3319723	enigma-dev	https://github.com/enigma-dev/enigma-dev	1	0	0	1
3320551	Check-My-Links	https://github.com/ocodia/Check-My-Links	1	0	0	1
3320710	ua-parser-js	https://github.com/faisalman/ua-parser-js	0	1	0	1
3327382	_s	https://github.com/Automattic/_s	0	1	0	1
3329923	helmet	https://github.com/evilpacket/helmet	2	0	0	2
3333183	css3test	https://github.com/LeaVerou/css3test	1	0	0	1
3333998	XChange	https://github.com/timmolter/XChange	1	0	0	1
3337657	wintersmith	https://github.com/jnordberg/wintersmith	0	2	0	2
3342046	rdflib	https://github.com/RDFLib/rdflib	1	0	0	1
3346849	brigade	https://github.com/codeforamerica/brigade	0	1	0	1
3350888	knockout-sortable	https://github.com/rniemeyer/knockout-sortable	1	0	0	1
3351871	qBittorrent	https://github.com/qbittorrent/qBittorrent	3	1	0	4
3353578	DevHub	https://github.com/volpe28v/DevHub	2	1	0	3
3355290	Fire-IE	https://github.com/yxl/Fire-IE	1	1	0	2
3362065	calabash-android	https://github.com/calabash/calabash-android	1	0	0	1
3362983	ona	https://github.com/opennetadmin/ona	1	0	0	1
3368497	photo-picker-plus	https://github.com/chute/photo-picker-plus	3	0	0	3
3370128	pgjdbc	https://github.com/pgjdbc/pgjdbc	0	1	0	1
3373793	DAKeyboardControl	https://github.com/danielamitay/DAKeyboardControl	1	1	0	2
3374036	atlas	https://github.com/PitonFoundation/atlas	1	1	0	2
3375197	llvmpy	https://github.com/llvmpy/llvmpy	1	1	0	2
3378433	libsocket	https://github.com/dermesser/libsocket	1	0	0	1
3378594	Requests	https://github.com/rmccue/Requests	1	0	0	1
3383374	circus	https://github.com/mozilla-services/circus	2	3	0	5
3390243	servo	https://github.com/mozilla/servo	5	2	0	7
3391701	geni-js-sdk	https://github.com/geni/geni-js-sdk	0	1	0	1
3391960	dcl	https://github.com/uhop/dcl	1	0	0	1
3395131	witch	https://github.com/Digit/witch	1	0	0	1
3395179	Dynamo	https://github.com/ikeough/Dynamo	2	3	0	5
3395524	obf	https://github.com/caulagi/obf	6	3	0	9
3398115	sublime-phpcs	https://github.com/benmatselby/sublime-phpcs	1	1	0	2
3398950	SkiTracker	https://github.com/rblaze/SkiTracker	0	1	0	1
3399062	Android-USB-Serial-Monitor-Lite	https://github.com/ksksue/Android-USB-Serial-Monitor-Lite	0	1	0	1
3400960	QUALIFIER	https://github.com/RGLab/QUALIFIER	1	2	0	3
3402899	yesod-paginator	https://github.com/pbrisbin/yesod-paginator	1	1	0	2
3404652	damiann.github.com	https://github.com/damiann/damiann.github.com	0	1	0	1
3407652	perfwatcher	https://github.com/perfwatcher/perfwatcher	1	0	0	1
3419399	rust-sdl	https://github.com/brson/rust-sdl	0	1	0	1
3422939	dropzone	https://github.com/enyo/dropzone	1	0	0	1
3425012	onebusaway-gtfs-realtime-exporter	https://github.com/OneBusAway/onebusaway-gtfs-realtime-exporter	1	0	0	1
3428329	sublemacspro	https://github.com/grundprinzip/sublemacspro	0	2	0	2
3431083	GPUImage	https://github.com/BradLarson/GPUImage	0	1	0	1
3431193	yii2	https://github.com/yiisoft/yii2	4	3	0	7
3434329	jQuery-Mobile-Bootstrap-Theme	https://github.com/commadelimited/jQuery-Mobile-Bootstrap-Theme	0	1	0	1
3434927	doppio	https://github.com/int3/doppio	1	0	0	1
3440414	dtbookOxygen	https://github.com/Notalib/dtbookOxygen	1	0	0	1
3445943	IBL-AbstractAlgebra	https://github.com/dcernst/IBL-AbstractAlgebra	1	0	0	1
3447278	liquibase.github.com	https://github.com/liquibase/liquibase.github.com	1	0	0	1
3447443	onebusaway-iphone	https://github.com/OneBusAway/onebusaway-iphone	13	5	0	18
3449477	collective.z3cform.widgets	https://github.com/collective/collective.z3cform.widgets	1	0	0	1
3449791	rear	https://github.com/rear/rear	1	0	0	1
3449886	intercom-ruby	https://github.com/intercom/intercom-ruby	1	0	0	1
3451238	yii	https://github.com/yiisoft/yii	1	0	0	1
3452220	spnet	https://github.com/cjlee112/spnet	2	0	0	2
3460049	carma	https://github.com/f-me/carma	3	2	0	5
3460824	Chorus	https://github.com/Chorus-bdd/Chorus	0	5	0	5
3461960	binb	https://github.com/lpinca/binb	0	1	0	1
3466494	Questor	https://github.com/ISeeDEDPpl/Questor	1	0	0	1
3470471	Font-Awesome	https://github.com/FortAwesome/Font-Awesome	6	3	1	10
3473163	cron-wrap	https://github.com/crustymonkey/cron-wrap	0	1	0	1
3473767	opam	https://github.com/OCamlPro/opam	3	2	0	5
3480666	graphhopper	https://github.com/graphhopper/graphhopper	0	1	1	2
3483944	homebrew-php	https://github.com/josegonzalez/homebrew-php	1	2	0	3
3507455	lila	https://github.com/ornicar/lila	1	1	0	2
3508073	PPRevealSideViewController	https://github.com/ipup/PPRevealSideViewController	1	3	0	4
3510804	GalSim	https://github.com/GalSim-developers/GalSim	0	5	0	5
3513943	sbt-cross-building	https://github.com/jrudolph/sbt-cross-building	0	1	0	1
3514615	JRebirth	https://github.com/JRebirth/JRebirth	0	1	0	1
3526586	fpinscala	https://github.com/pchiusano/fpinscala	2	0	0	2
3526990	tweereal	https://github.com/defly/tweereal	1	0	0	1
3538325	marca	https://github.com/calliopeinitiative/marca	1	0	0	1
3545112	Wicket	https://github.com/arthur-e/Wicket	1	0	0	1
3548254	titan	https://github.com/thinkaurelius/titan	2	2	0	4
3553108	bootstrap-combobox	https://github.com/danielfarrell/bootstrap-combobox	1	0	0	1
3556021	jQuery-Mobile-Icon-Pack	https://github.com/commadelimited/jQuery-Mobile-Icon-Pack	0	1	0	1
3560973	plugin-Groups	https://github.com/omeka/plugin-Groups	1	0	0	1
3564353	Baikal	https://github.com/jeromeschneider/Baikal	2	0	0	2
3565570	pah	https://github.com/Helabs/pah	2	0	0	2
3577919	beego	https://github.com/astaxie/beego	1	1	0	2
3579237	Shimmer	https://github.com/github/Shimmer	1	3	0	4
3582763	MyExpenses	https://github.com/mtotschnig/MyExpenses	1	0	0	1
3584229	WurstScript	https://github.com/peq/WurstScript	0	1	0	1
3587897	nginx-http-slice	https://github.com/alibaba/nginx-http-slice	1	0	0	1
3588052	roxy	https://github.com/marklogic/roxy	3	1	0	4
3602123	hammer.js	https://github.com/EightMedia/hammer.js	2	0	0	2
3602598	FieldDB	https://github.com/OpenSourceFieldlinguistics/FieldDB	8	3	0	11
3603910	node-sqlserver	https://github.com/WindowsAzure/node-sqlserver	1	0	0	1
3606624	ReactiveCocoa	https://github.com/ReactiveCocoa/ReactiveCocoa	2	2	0	4
3606738	cesium	https://github.com/AnalyticalGraphicsInc/cesium	2	1	0	3
3610323	calabash-ios	https://github.com/calabash/calabash-ios	2	2	0	4
3610486	Nominatim	https://github.com/twain47/Nominatim	0	1	0	1
3615238	Denizen	https://github.com/aufdemrand/Denizen	4	8	1	13
3616611	hd	https://github.com/glasklart/hd	9	0	1	10
3616639	KineticJS	https://github.com/ericdrowell/KineticJS	1	0	0	1
3617991	closure-boilerplate	https://github.com/jankuca/closure-boilerplate	1	0	0	1
3620194	select2	https://github.com/ivaynberg/select2	3	4	0	7
3621462	oi-live	https://github.com/koniiiik/oi-live	1	0	0	1
3623050	homebrew-cask	https://github.com/phinze/homebrew-cask	3	1	0	4
3631697	tsuru	https://github.com/globocom/tsuru	1	0	0	1
3638964	ansible	https://github.com/ansible/ansible	5	9	0	14
3639450	stemkoski.github.com	https://github.com/stemkoski/stemkoski.github.com	0	3	0	3
3645628	resetmsmice	https://github.com/paulrichards321/resetmsmice	0	1	0	1
3648886	SiriServerCore	https://github.com/Eichhoernchen/SiriServerCore	1	0	0	1
3652300	origo	https://github.com/origocms/origo	0	1	0	1
3652822	flask-security	https://github.com/mattupstate/flask-security	2	0	0	2
3654364	roo	https://github.com/Empact/roo	1	0	0	1
3662248	gitscm-next	https://github.com/github/gitscm-next	1	0	0	1
3668353	aralejs.org	https://github.com/aralejs/aralejs.org	1	0	0	1
3669065	openpgp-keychain	https://github.com/dschuermann/openpgp-keychain	22	14	0	36
3675152	Guide-on-the-Side	https://github.com/ualibraries/Guide-on-the-Side	0	1	0	1
3687291	flask-login	https://github.com/maxcountryman/flask-login	0	1	0	1
3689718	moq4	https://github.com/Moq/moq4	0	1	0	1
3701791	sofin	https://github.com/VerKnowSys/sofin	1	1	0	2
3701855	http-kit	https://github.com/http-kit/http-kit	1	0	0	1
3705857	pcapfix	https://github.com/Rup0rt/pcapfix	0	1	0	1
3710711	github3.py	https://github.com/sigmavirus24/github3.py	1	1	0	2
3711416	activeresource	https://github.com/rails/activeresource	1	0	0	1
3713248	HTML5-History-API	https://github.com/devote/HTML5-History-API	1	0	0	1
3714900	nginx-rtmp-module	https://github.com/arut/nginx-rtmp-module	1	0	0	1
3718579	TiShadow	https://github.com/dbankier/TiShadow	1	1	0	2
3721224	Swiper	https://github.com/nolimits4web/Swiper	1	0	0	1
3722168	mongomock	https://github.com/vmalloc/mongomock	0	1	0	1
3723402	Pylinter	https://github.com/biermeester/Pylinter	0	1	0	1
3727706	helm	https://github.com/emacs-helm/helm	1	0	0	1
3728161	cabal	https://github.com/haskell/cabal	2	2	1	5
3729070	Nuts-CMS	https://github.com/h2lsoft/Nuts-CMS	11	0	0	11
3729629	dotCMS	https://github.com/dotCMS/dotCMS	10	2	0	12
3732452	nbproject	https://github.com/nbproject/nbproject	4	0	0	4
3734766	bootswatch-rails	https://github.com/maxim/bootswatch-rails	1	0	0	1
3737451	rumbo-fb	https://github.com/mozillahispano/rumbo-fb	0	1	0	1
3738302	django-templatetag-handlebars	https://github.com/makinacorpus/django-templatetag-handlebars	1	0	0	1
3738732	traco	https://github.com/barsoom/traco	0	1	0	1
3741059	moox.io	https://github.com/MoOx/moox.io	1	0	0	1
3747390	activeadmin-mongoid	https://github.com/elia/activeadmin-mongoid	1	0	0	1
3749321	Unblock-Youku	https://github.com/zhuzhuor/Unblock-Youku	1	0	0	1
3751713	PHP-DI	https://github.com/mnapoli/PHP-DI	1	0	0	1
3757512	sails	https://github.com/balderdashy/sails	1	2	0	3
3759519	sublime-csslint	https://github.com/austinhappel/sublime-csslint	0	1	0	1
3760052	superslides	https://github.com/nicinabox/superslides	2	2	0	4
3768822	BP-Groups-Extras	https://github.com/slaFFik/BP-Groups-Extras	0	2	0	2
3770150	cassava	https://github.com/tibbe/cassava	1	0	0	1
3770454	katello.auto	https://github.com/RedHatQE/katello.auto	1	0	0	1
3770693	punch	https://github.com/laktek/punch	0	1	0	1
3774936	everpad	https://github.com/nvbn/everpad	1	0	0	1
3782132	quickfort	https://github.com/joelpt/quickfort	1	0	0	1
3783237	AustESE	https://github.com/uq-eresearch/AustESE	0	1	0	1
3786218	inspircd	https://github.com/inspircd/inspircd	1	0	0	1
3786231	Pearl-PBX	https://github.com/radetsky/Pearl-PBX	0	0	1	1
3786237	hazelcast	https://github.com/hazelcast/hazelcast	0	1	0	1
3790293	ghostdriver	https://github.com/detro/ghostdriver	0	1	0	1
3791436	promisejs	https://github.com/stackp/promisejs	1	1	0	2
3798289	on.video	https://github.com/muellert/on.video	0	1	0	1
3801323	liferayImageSlider	https://github.com/rotterdam-cs/liferayImageSlider	1	0	0	1
3802570	SaltarelleCompiler	https://github.com/erik-kallen/SaltarelleCompiler	1	0	0	1
3802828	goproxy	https://github.com/elazarl/goproxy	0	0	1	1
3804851	SCII-External-Maphack	https://github.com/MrNukealizer/SCII-External-Maphack	6	0	0	6
3813427	CakePHP-Rest-Datasource	https://github.com/nodesagency/CakePHP-Rest-Datasource	0	1	0	1
3814221	the-red-spider-project	https://github.com/the-xkcd-community/the-red-spider-project	0	1	0	1
3814824	Energia	https://github.com/energia/Energia	0	3	0	3
3826280	amqp-client	https://github.com/sstone/amqp-client	1	0	0	1
3827595	buildout	https://github.com/buildout/buildout	1	0	0	1
3829913	websocket-rails	https://github.com/DanKnox/websocket-rails	1	0	0	1
3829960	loopinfinito.com.br	https://github.com/loopinfinito/loopinfinito.com.br	0	1	0	1
3830391	WP-Benchmark	https://github.com/topdown/WP-Benchmark	1	0	0	1
3836167	job-dsl-plugin	https://github.com/JavaPosseRoundup/job-dsl-plugin	1	2	1	4
3837363	metamonger	https://github.com/RichiH/metamonger	1	0	0	1
3842034	magirc	https://github.com/h9k/magirc	1	1	0	2
3842593	ruby-china	https://github.com/ruby-china/ruby-china	1	0	0	1
3843585	akvo-flow	https://github.com/akvo/akvo-flow	1	0	0	1
3844477	micrajax	https://github.com/shane-tomlinson/micrajax	1	0	0	1
3849558	Youtube-Video-Annotations-Player	https://github.com/ttsiodras/Youtube-Video-Annotations-Player	1	0	0	1
3860001	gfm	https://github.com/p0nce/gfm	3	0	0	3
3862697	Elgg	https://github.com/Srokap/Elgg	1	0	0	1
3864378	img2pdf	https://github.com/josch/img2pdf	1	0	0	1
3865180	TravianZ	https://github.com/yi12345/TravianZ	2	2	0	4
3867138	om	https://github.com/projecthydra/om	1	0	0	1
3867913	hypeAlive	https://github.com/hypeJunction/hypeAlive	1	0	0	1
3868118	bamboo	https://github.com/modilabs/bamboo	0	1	0	1
3868392	hypeCategories	https://github.com/hypeJunction/hypeCategories	0	1	0	1
3869901	FluidCinder	https://github.com/kotsoft/FluidCinder	1	0	0	1
3870168	ruhoh.rb	https://github.com/ruhoh/ruhoh.rb	1	0	0	1
3880513	johnny-five	https://github.com/rwaldron/johnny-five	1	1	0	2
3882067	ESCan	https://github.com/hawaiianchimp/ESCan	4	1	0	5
3883664	tutor	https://github.com/davidchambers/tutor	0	3	0	3
3884105	widget	https://github.com/twinh/widget	1	0	0	1
3900538	wasync	https://github.com/Atmosphere/wasync	1	0	0	1
3910314	bosh	https://github.com/cloudfoundry/bosh	1	0	0	1
3910382	figaro	https://github.com/laserlemon/figaro	1	1	0	2
3910478	hbird-business	https://github.com/Villemos/hbird-business	0	1	0	1
3910945	h	https://github.com/hypothesis/h	1	3	0	4
3912538	novocaine	https://github.com/alexbw/novocaine	0	1	0	1
3913468	stormpath-sdk-java	https://github.com/stormpath/stormpath-sdk-java	1	0	0	1
3919345	continuous-enterprise-development	https://github.com/arquillian/continuous-enterprise-development	3	2	0	5
3921611	mapserver	https://github.com/mapserver/mapserver	1	1	0	2
3934931	chef-statsd	https://github.com/hectcastro/chef-statsd	1	0	0	1
3939907	Piratenkleider	https://github.com/xwolfde/Piratenkleider	0	1	0	1
3941733	GWT-Eureka	https://github.com/ctasada/GWT-Eureka	0	2	0	2
3943798	mockito-groovy-support	https://github.com/cyrusinnovation/mockito-groovy-support	1	0	0	1
3943915	trello-py	https://github.com/tghw/trello-py	1	0	0	1
3944100	ooni-probe	https://github.com/TheTorProject/ooni-probe	2	1	0	3
3948501	php-github-api	https://github.com/KnpLabs/php-github-api	1	0	0	1
3953511	DrupalDroid	https://github.com/voidberg/DrupalDroid	1	1	0	2
3957082	hdo-site	https://github.com/holderdeord/hdo-site	2	0	0	2
3957586	ashikawa-core	https://github.com/triAGENS/ashikawa-core	1	0	0	1
3961425	Easy-Digital-Downloads	https://github.com/easydigitaldownloads/Easy-Digital-Downloads	2	0	0	2
3972591	python-amazon-simple-product-api	https://github.com/yoavaviram/python-amazon-simple-product-api	2	1	0	3
3972703	Wordpress-Cuztom-Helper	https://github.com/Gizburdt/Wordpress-Cuztom-Helper	1	1	0	2
3974250	PkModeling	https://github.com/millerjv/PkModeling	0	1	0	1
3978001	b3log-solo	https://github.com/b3log/b3log-solo	2	0	0	2
3981653	annotations	https://github.com/entwinemedia/annotations	0	1	0	1
3983388	DemoSite	https://github.com/BroadleafCommerce/DemoSite	1	0	0	1
3984581	1Tuts	https://github.com/AliMD/1Tuts	2	0	0	2
3987136	wordpress	https://github.com/facebook/wordpress	0	1	0	1
3988222	npm_lazy	https://github.com/mixu/npm_lazy	0	1	0	1
3989388	cf-release	https://github.com/cloudfoundry/cf-release	1	0	0	1
3997220	NoItem	https://github.com/World-of-Tomorrow/NoItem	1	0	0	1
4000919	subdomain	https://github.com/edwardhotchkiss/subdomain	1	1	0	2
4002075	luasocket	https://github.com/diegonehab/luasocket	0	3	0	3
4003232	TrenchBroom	https://github.com/kduske/TrenchBroom	1	0	0	1
4006121	ScalaIde	https://github.com/themerius/ScalaIde	1	0	0	1
4007018	katello	https://github.com/Katello/katello	4	0	0	4
4007079	salesforce_bulk_api	https://github.com/yatishmehta27/salesforce_bulk_api	0	1	0	1
4009638	vim-config	https://github.com/pivotalcommon/vim-config	1	0	0	1
4012450	USB-MIDI-Driver	https://github.com/kshoji/USB-MIDI-Driver	0	1	0	1
4012544	yeoman	https://github.com/yeoman/yeoman	1	1	0	2
4015554	FPPopover	https://github.com/50pixels/FPPopover	1	0	0	1
4022258	jumpOnJuniper	https://github.com/mobilemind/jumpOnJuniper	1	0	0	1
4022719	dita-ot	https://github.com/dita-ot/dita-ot	1	1	0	2
4025121	nikola	https://github.com/ralsina/nikola	12	5	1	18
4032943	daybed	https://github.com/spiral-project/daybed	1	0	0	1
4036328	laravel-smtp	https://github.com/swt83/laravel-smtp	1	0	0	1
4037197	YouCompleteMe	https://github.com/Valloric/YouCompleteMe	2	2	0	4
4038899	backmeup-frontend	https://github.com/backmeup/backmeup-frontend	2	0	0	2
4038949	traccar	https://github.com/tananaev/traccar	1	1	0	2
4039952	BuildCraft	https://github.com/BuildCraft/BuildCraft	4	2	0	6
4041021	snap-web	https://github.com/HaskellCNOrg/snap-web	1	0	0	1
4043050	Wurfel-Engine	https://github.com/Cbeed/Wurfel-Engine	1	2	0	3
4046328	Ratchet	https://github.com/cboden/Ratchet	1	0	0	1
4047360	befdata	https://github.com/befdata/befdata	1	0	0	1
4054874	xbmclibraryautoupdate	https://github.com/robweber/xbmclibraryautoupdate	0	1	0	1
4058868	pokecrystal	https://github.com/kanzure/pokecrystal	1	3	0	4
4059172	openDCIM	https://github.com/samilliken/openDCIM	0	3	0	3
4060587	bd	https://github.com/vigneshwaranr/bd	1	1	0	2
4064462	HighchartsPHP	https://github.com/ghunti/HighchartsPHP	0	1	0	1
4064787	ADL_LRS	https://github.com/adlnet/ADL_LRS	0	1	0	1
4081339	-Coin	https://github.com/Someguy123/-Coin	2	0	0	2
4083576	de.flapdoodle.embed.mongo	https://github.com/flapdoodle-oss/de.flapdoodle.embed.mongo	1	0	0	1
4085129	swig-v8	https://github.com/oliver----/swig-v8	0	1	0	1
4095287	rubocop	https://github.com/bbatsov/rubocop	2	0	0	2
4097418	ofxNSWindower	https://github.com/whg/ofxNSWindower	1	1	0	2
4100971	EteRNA-public	https://github.com/EteRNAgame/EteRNA-public	1	0	0	1
4101095	TFCraft	https://github.com/Deadrik/TFCraft	3	1	0	4
4103777	dbpedia-spotlight	https://github.com/dbpedia-spotlight/dbpedia-spotlight	1	0	0	1
4106102	client	https://github.com/StratusLab/client	1	0	0	1
4106193	storage	https://github.com/StratusLab/storage	1	0	0	1
4106424	one	https://github.com/StratusLab/one	1	0	0	1
4106454	use-cases	https://github.com/StratusLab/use-cases	1	0	0	1
4106792	homebrew-science	https://github.com/Homebrew/homebrew-science	0	1	0	1
4110611	mapproxy	https://github.com/mapproxy/mapproxy	1	0	0	1
4118855	slow-cheetah	https://github.com/sayedihashimi/slow-cheetah	1	2	0	3
4124657	ace-builds	https://github.com/ajaxorg/ace-builds	1	1	0	2
4126171	rubedo	https://github.com/WebTales/rubedo	1	0	0	1
4127088	azure-sdk-for-python	https://github.com/WindowsAzure/azure-sdk-for-python	1	0	0	1
4127095	azure-sdk-for-ruby	https://github.com/WindowsAzure/azure-sdk-for-ruby	3	0	0	3
4128408	Durandal	https://github.com/BlueSpire/Durandal	2	0	0	2
4128628	evernote-sdk-android	https://github.com/evernote/evernote-sdk-android	1	0	0	1
4133153	Reminders	https://github.com/brockangelo/Reminders	1	0	0	1
4134880	scalalogging	https://github.com/typesafehub/scalalogging	1	1	0	2
4137249	test-kitchen	https://github.com/opscode/test-kitchen	1	0	0	1
4146761	nodizecms	https://github.com/nodize/nodizecms	1	0	0	1
4147205	cismet-commons	https://github.com/cismet/cismet-commons	0	1	0	1
4147368	cismet-gui-commons	https://github.com/cismet/cismet-gui-commons	0	1	0	1
4149028	mootiro-maps	https://github.com/it3s/mootiro-maps	0	6	0	6
4150226	ANE-Flurry	https://github.com/freshplanet/ANE-Flurry	1	0	0	1
4152339	anjlab-widgets	https://github.com/anjlab/anjlab-widgets	1	0	0	1
4158448	mage	https://github.com/magefree/mage	1	0	0	1
4159737	Impact-MultiTouch	https://github.com/Houly/Impact-MultiTouch	1	0	0	1
4173125	google-drive-ruby	https://github.com/gimite/google-drive-ruby	1	0	0	1
4174733	salt-cloud	https://github.com/saltstack/salt-cloud	1	0	0	1
4174809	bold	https://github.com/fillest/bold	6	0	0	6
4177932	GotCms	https://github.com/GotCms/GotCms	1	0	0	1
4182696	MopaComposerBridge	https://github.com/phiamo/MopaComposerBridge	1	1	0	2
4182849	sass-maven-plugin	https://github.com/Jasig/sass-maven-plugin	1	0	0	1
4188772	toastr	https://github.com/CodeSeven/toastr	1	0	0	1
4190053	brandico.font	https://github.com/fontello/brandico.font	1	0	0	1
4190517	chap-links-library	https://github.com/almende/chap-links-library	1	1	0	2
4191571	JEvents	https://github.com/JEvents/JEvents	2	0	0	2
4193432	docs	https://github.com/contao/docs	1	0	0	1
4193864	mct	https://github.com/nasa/mct	2	0	0	2
4194908	jaydata	https://github.com/jaydata/jaydata	0	1	0	1
4198043	MAVProxy	https://github.com/tridge/MAVProxy	1	0	0	1
4198124	cuav	https://github.com/tridge/cuav	1	0	0	1
4199001	node-wd-sync	https://github.com/sebv/node-wd-sync	1	0	0	1
4202722	dbinbox	https://github.com/christiangenco/dbinbox	2	0	0	2
4205148	rested	https://github.com/hellopatrick/rested	1	0	0	1
4207519	playground	https://github.com/rsanheim-org/playground	154	0	0	154
4211913	flot.stackpercent	https://github.com/skeleton9/flot.stackpercent	1	0	0	1
4213474	Humanizer	https://github.com/MehdiK/Humanizer	1	0	0	1
4225735	symbiose	https://github.com/symbiose/symbiose	1	0	0	1
4226296	Products.Ploneboard	https://github.com/collective/Products.Ploneboard	0	1	0	1
4228254	Starcounter	https://github.com/Starcounter/Starcounter	17	6	1	24
4234626	mozilla-hispano.org	https://github.com/mozillahispano/mozilla-hispano.org	1	0	0	1
4237289	mupen64plus-ae	https://github.com/paulscode/mupen64plus-ae	1	0	0	1
4238977	swagger-springmvc	https://github.com/martypitt/swagger-springmvc	0	1	0	1
4244443	Strut	https://github.com/tantaman/Strut	0	1	0	1
4244828	ObjectiveRecord	https://github.com/mneorr/ObjectiveRecord	0	1	0	1
4245765	mybatis-pagination	https://github.com/yfyang/mybatis-pagination	0	1	0	1
4248640	wire	https://github.com/wiremod/wire	0	2	1	3
4248668	work_allocation	https://github.com/gk0r/work_allocation	0	2	0	2
4254338	graphite-web	https://github.com/graphite-project/graphite-web	1	0	0	1
4254844	select2-rails	https://github.com/argerim/select2-rails	0	3	0	3
4261187	nodyn	https://github.com/projectodd/nodyn	1	0	0	1
4263606	core-autodeploy	https://github.com/zenoss/core-autodeploy	2	0	0	2
4263646	imagecrawler	https://github.com/jaylinski/imagecrawler	1	0	0	1
4264064	simperium-ios	https://github.com/Simperium/simperium-ios	2	0	0	2
4264671	Lucene.Net.Linq	https://github.com/themotleyfool/Lucene.Net.Linq	2	1	0	3
4268140	moment-timezone	https://github.com/moment/moment-timezone	1	0	0	1
4270226	katello-api	https://github.com/gkhachik/katello-api	18	1	0	19
4270434	EZForm	https://github.com/chrismiles/EZForm	0	1	0	1
4279682	fish-shell	https://github.com/fish-shell/fish-shell	2	0	0	2
4282426	vtrunkd	https://github.com/grandrew/vtrunkd	1	7	0	8
4283348	NUL	https://github.com/TUD-OS/NUL	2	0	0	2
4284030	cocos2dx-win8	https://github.com/cocos2d-x/cocos2dx-win8	1	0	0	1
4285532	pretty_face	https://github.com/cheezy/pretty_face	0	1	0	1
4287066	respec	https://github.com/darobin/respec	0	1	0	1
4288682	Twister	https://github.com/Luxoft/Twister	0	2	0	2
4290226	emacs-live	https://github.com/overtone/emacs-live	1	0	0	1
4292824	uiaplist-to-junit-converter	https://github.com/thegeorgelee/uiaplist-to-junit-converter	1	0	0	1
4297273	wet-boew	https://github.com/wet-boew/wet-boew	1	0	0	1
4298511	librarian	https://github.com/uvNikita/librarian	1	1	0	2
4311796	markdown-here	https://github.com/adam-p/markdown-here	1	1	0	2
4317381	ftscroller	https://github.com/ftlabs/ftscroller	1	0	0	1
4319172	fisa-vim-config	https://github.com/fisadev/fisa-vim-config	1	1	0	2
4324734	mozmill-automation	https://github.com/mozilla/mozmill-automation	0	1	0	1
4331833	khmer	https://github.com/ged-lab/khmer	2	1	0	3
4333252	guake	https://github.com/Guake/guake	1	0	0	1
4335832	ResInsight	https://github.com/OPM/ResInsight	4	0	0	4
4337654	Touchfolio	https://github.com/dimsemenov/Touchfolio	1	0	0	1
4338685	teacup	https://github.com/rubymotion/teacup	1	1	0	2
4341072	commotion-openwrt	https://github.com/opentechinstitute/commotion-openwrt	4	0	0	4
4349914	statsd-librato-backend	https://github.com/librato/statsd-librato-backend	0	1	0	1
4370755	frontend	https://github.com/guardian/frontend	6	1	0	7
4374695	ruby-box	https://github.com/attachmentsme/ruby-box	1	0	0	1
4374825	wet-boew-drupal	https://github.com/wet-boew/wet-boew-drupal	0	10	0	10
4379322	minecraft-server-manager	https://github.com/marcuswhybrow/minecraft-server-manager	3	1	0	4
4383030	hawkthorne-journey	https://github.com/hawkthorne/hawkthorne-journey	1	2	0	3
4384018	madge	https://github.com/pahen/madge	1	0	0	1
4384836	superscrollorama	https://github.com/johnpolacek/superscrollorama	2	0	0	2
4385294	thymeleaf	https://github.com/thymeleaf/thymeleaf	0	1	0	1
4386648	mwparserfromhell	https://github.com/earwig/mwparserfromhell	1	0	0	1
4390795	islay-shop	https://github.com/spookandpuff/islay-shop	1	1	0	2
4391145	rot.js	https://github.com/ondras/rot.js	0	0	1	1
4392591	feelpp	https://github.com/feelpp/feelpp	1	0	0	1
4394977	bind-form	https://github.com/jillix/bind-form	1	0	0	1
4395840	blender_mmd_tools	https://github.com/sugiany/blender_mmd_tools	0	1	0	1
4396471	revolution	https://github.com/alnsnk/revolution	1	1	1	3
4396535	sinatra-activerecord	https://github.com/janko-m/sinatra-activerecord	1	0	0	1
4408770	libxplanemp	https://github.com/wadesworld2112/libxplanemp	1	0	0	1
4421513	mozdownload	https://github.com/mozilla/mozdownload	2	1	0	3
4423334	navajo	https://github.com/Dexels/navajo	1	0	0	1
4425044	html5-template	https://github.com/daspecster/html5-template	1	1	0	2
4433149	titanium	https://github.com/appcelerator/titanium	1	0	0	1
4433540	migration-manager	https://github.com/typesafehub/migration-manager	1	0	0	1
4434126	shoes4	https://github.com/shoes/shoes4	0	1	0	1
4435164	LEMPress	https://github.com/okor/LEMPress	1	0	0	1
4437606	Palamedes	https://github.com/nikpapa/Palamedes	1	1	0	2
4449830	webcam-capture	https://github.com/sarxos/webcam-capture	0	1	0	1
4450045	Elgg_1.8_elggx_userpoints	https://github.com/iionly/Elgg_1.8_elggx_userpoints	0	1	0	1
4455628	hpx	https://github.com/STEllAR-GROUP/hpx	4	4	0	8
4458658	text	https://github.com/requirejs/text	1	0	0	1
4472401	WhatsAPI	https://github.com/venomous0x/WhatsAPI	0	1	0	1
4475999	Catroid	https://github.com/Catrobat/Catroid	3	2	0	5
4491015	Cloudgen.js	https://github.com/Ninjakannon/Cloudgen.js	0	1	0	1
4493652	yeoman.io	https://github.com/yeoman/yeoman.io	0	1	0	1
4498553	openyoudao	https://github.com/justzx2011/openyoudao	0	5	0	5
4501479	JSX	https://github.com/jsx/JSX	3	0	0	3
4505364	IntegraLive	https://github.com/BirminghamConservatoire/IntegraLive	1	10	0	11
4505394	fervor	https://github.com/pypt/fervor	1	0	0	1
4510373	python-ccuapi	https://github.com/dryan/python-ccuapi	1	0	0	1
4521463	www.gittip.com	https://github.com/gittip/www.gittip.com	3	5	0	8
4523235	asciidoctor	https://github.com/asciidoctor/asciidoctor	2	0	0	2
4530703	LogisticsPipes	https://github.com/RS485/LogisticsPipes	1	1	0	2
4531751	elasticsearch-test	https://github.com/tlrx/elasticsearch-test	1	0	0	1
4539894	examples	https://github.com/jasonandrewduncan/examples	3	1	0	4
4540793	ytplayer	https://github.com/janpecha/ytplayer	3	0	0	3
4542711	nixos	https://github.com/NixOS/nixos	2	0	0	2
4545613	MPFlipViewController	https://github.com/mpospese/MPFlipViewController	1	0	0	1
4554394	post-forking	https://github.com/post-forking/post-forking	0	1	0	1
4555894	Leaflet.draw	https://github.com/Leaflet/Leaflet.draw	1	0	0	1
4564034	jxmapviewer2	https://github.com/msteiger/jxmapviewer2	0	1	0	1
4573694	public-static	https://github.com/dreikanter/public-static	7	1	0	8
4578898	habitrpg	https://github.com/lefnire/habitrpg	12	278	7	297
4580572	exit-web-framework	https://github.com/exitsoft/exit-web-framework	0	1	0	1
4582459	owncloud	https://github.com/hypery2k/owncloud	1	0	0	1
4582627	represent-map	https://github.com/abenzer/represent-map	0	3	0	3
4583144	spyc	https://github.com/mustangostang/spyc	1	0	0	1
4585668	slidify	https://github.com/ramnathv/slidify	1	0	0	1
4589223	json-forms	https://github.com/medic/json-forms	1	0	0	1
4591840	build	https://github.com/phonegap/build	0	2	0	2
4595580	html5-google-authenticator	https://github.com/gbraad/html5-google-authenticator	0	1	0	1
4599058	kriss_feed	https://github.com/tontof/kriss_feed	1	2	0	3
4600400	PushSharp	https://github.com/Redth/PushSharp	1	0	0	1
4604245	bootstrap-cdn	https://github.com/MaxCDN/bootstrap-cdn	4	4	0	8
4604367	sirix	https://github.com/sirixdb/sirix	1	0	0	1
4606342	serengeti-ws	https://github.com/vmware-serengeti/serengeti-ws	1	1	0	2
4609721	server	https://github.com/payutc/server	1	0	0	1
4611021	brackets-csslint	https://github.com/cfjedimaster/brackets-csslint	1	0	0	1
4611939	Base64.js	https://github.com/davidchambers/Base64.js	0	1	0	1
4618971	flylatex	https://github.com/alabid/flylatex	0	2	0	2
4619437	gulo	https://github.com/VertNet/gulo	1	0	0	1
4620840	huxley	https://github.com/bmun/huxley	1	1	0	2
4623665	adsphd	https://github.com/wannesm/adsphd	1	0	0	1
4634707	HiBench	https://github.com/intel-hadoop/HiBench	1	0	0	1
4640263	Nestable	https://github.com/dbushell/Nestable	1	0	0	1
4653174	puppetlabs-puppetdb	https://github.com/puppetlabs/puppetlabs-puppetdb	1	0	0	1
4655157	aurora.js	https://github.com/audiocogs/aurora.js	1	1	0	2
4660289	LEPTON_2_BlackCat	https://github.com/webbird/LEPTON_2_BlackCat	1	1	0	2
4665416	bolt	https://github.com/bolt/bolt	3	3	0	6
4665529	brackets-jshint	https://github.com/cfjedimaster/brackets-jshint	1	0	0	1
4674119	andlytics	https://github.com/AndlyticsProject/andlytics	1	0	0	1
4676222	mimosa	https://github.com/dbashford/mimosa	1	2	0	3
4686114	PySCXML	https://github.com/jroxendal/PySCXML	1	0	0	1
4693087	travis-web	https://github.com/travis-ci/travis-web	1	1	0	2
4693986	CanaryLib	https://github.com/FallenMoonNetwork/CanaryLib	0	1	0	1
4696667	Bootstrap-Form-Builder	https://github.com/minikomi/Bootstrap-Form-Builder	0	4	0	4
4697580	FactionsPlus	https://github.com/MarkehMe/FactionsPlus	1	0	0	1
4697589	analytics.js	https://github.com/segmentio/analytics.js	1	0	0	1
4702310	Killer	https://github.com/KillerMinecraft/Killer	1	1	0	2
4703747	chemmine-ei	https://github.com/ucr-bioinformatics/chemmine-ei	2	1	0	3
4705818	NerdBugs	https://github.com/NerdNu/NerdBugs	1	0	0	1
4705942	jwamp	https://github.com/ghetolay/jwamp	1	0	0	1
4709434	MavensMate-SublimeText	https://github.com/joeferraro/MavensMate-SublimeText	1	0	0	1
4709775	Terrastation-13	https://github.com/addictgamer/Terrastation-13	0	2	0	2
4713853	OpenSMTPD	https://github.com/poolpOrg/OpenSMTPD	0	4	0	4
4714614	dc.js	https://github.com/NickQiZhu/dc.js	1	0	0	1
4715906	garner	https://github.com/artsy/garner	1	0	0	1
4716235	lua-amf3	https://github.com/neoxic/lua-amf3	1	0	0	1
4717020	mage-enhanced-admin-grids	https://github.com/mage-eag/mage-enhanced-admin-grids	0	1	0	1
4719523	google-drive-ocamlfuse	https://github.com/astrada/google-drive-ocamlfuse	1	1	0	2
4720064	citizenbudgetapp.com	https://github.com/opennorth/citizenbudgetapp.com	0	1	0	1
4722169	pidgin-lwqq	https://github.com/xiehuc/pidgin-lwqq	1	0	0	1
4723248	ol3	https://github.com/openlayers/ol3	4	4	1	9
4729944	shiny	https://github.com/rstudio/shiny	1	1	0	2
4731090	mcxToProfile	https://github.com/timsutton/mcxToProfile	1	1	0	2
4732384	mangodb	https://github.com/dcramer/mangodb	1	0	0	1
4733263	C-PAC	https://github.com/FCP-INDI/C-PAC	0	1	0	1
4735878	orbisgis	https://github.com/irstv/orbisgis	1	4	0	5
4736985	documentation-code	https://github.com/ariatemplates/documentation-code	1	0	0	1
4738329	hfcca	https://github.com/terryyin/hfcca	2	1	0	3
4742443	imp	https://github.com/salilab/imp	1	0	0	1
4743045	Astronomical-Proportions	https://github.com/VT-CHCI/Astronomical-Proportions	1	0	0	1
4749289	mptcp	https://github.com/multipath-tcp/mptcp	0	1	0	1
4750007	diamondash	https://github.com/praekelt/diamondash	4	0	0	4
4751156	ripla	https://github.com/aktion-hip/ripla	1	0	0	1
4755771	TurkGate	https://github.com/gideongoldin/TurkGate	1	0	0	1
4771836	emoji	https://github.com/fengmk2/emoji	1	0	0	1
4777187	formotion	https://github.com/clayallsopp/formotion	0	1	0	1
4780572	hoodie.js	https://github.com/hoodiehq/hoodie.js	0	1	0	1
4787431	rpg_battlemap	https://github.com/lordnull/rpg_battlemap	2	0	0	2
4787500	opm-core	https://github.com/OPM/opm-core	1	0	0	1
4789337	meteorite	https://github.com/oortcloud/meteorite	2	1	0	3
4796912	MegaList	https://github.com/triceam/MegaList	1	0	0	1
4799657	JIRA-php	https://github.com/FayP/JIRA-php	1	0	0	1
4800959	Thinktecture.IdentityServer.v2	https://github.com/thinktecture/Thinktecture.IdentityServer.v2	2	0	0	2
4806914	Music-Free-Responsive-Joomla-Template	https://github.com/GavickPro/Music-Free-Responsive-Joomla-Template	0	1	0	1
4811862	CookieCadger	https://github.com/CookieCadger/CookieCadger	0	1	0	1
4813181	czbox	https://github.com/janpecha/czbox	2	0	0	2
4821913	BattleNET	https://github.com/ziellos2k/BattleNET	0	1	0	1
4826094	RasPiBrew	https://github.com/steve71/RasPiBrew	0	1	0	1
4829686	django-ios-notifications	https://github.com/stephenmuss/django-ios-notifications	0	2	0	2
4831553	YALMIP	https://github.com/johanlofberg/YALMIP	1	0	0	1
4838750	Expect-for-Java	https://github.com/ronniedong/Expect-for-Java	0	2	0	2
4839957	SlidingMenu	https://github.com/jfeinstein10/SlidingMenu	2	0	0	2
4846607	node-gcm	https://github.com/ToothlessGear/node-gcm	1	0	0	1
4853848	spectre	https://github.com/johnmccutchan/spectre	2	2	1	5
4858466	intermine	https://github.com/intermine/intermine	1	0	0	1
4864801	restful_json	https://github.com/FineLinePrototyping/restful_json	0	1	0	1
4867294	TadpoleForDBTools	https://github.com/hangum/TadpoleForDBTools	2	4	0	6
4868311	sublime-coffee-compile	https://github.com/surjikal/sublime-coffee-compile	2	0	0	2
4869758	Sublime-Wrap-Plus	https://github.com/ehuss/Sublime-Wrap-Plus	1	0	0	1
4871100	ximpia	https://github.com/Ximpia/ximpia	2	2	0	4
4871551	cartodb.js	https://github.com/CartoDB/cartodb.js	2	1	0	3
4872519	collective.analyticspanel	https://github.com/RedTurtle/collective.analyticspanel	0	1	1	2
4872558	travel	https://github.com/lstoll/travel	1	0	0	1
4872945	bootstrap-tour	https://github.com/sorich87/bootstrap-tour	0	1	0	1
4875685	metrics-librato	https://github.com/librato/metrics-librato	0	4	0	4
4882341	AsciiIngest	https://github.com/adrpar/AsciiIngest	0	1	0	1
4884452	pyFF	https://github.com/leifj/pyFF	3	0	0	3
4884597	gwtp-eclipse-plugin	https://github.com/ArcBees/gwtp-eclipse-plugin	0	1	0	1
4885383	VimFx	https://github.com/akhodakivskiy/VimFx	4	3	0	7
4886615	qutepart	https://github.com/hlamer/qutepart	1	0	0	1
4889219	gravatar-component	https://github.com/LearnBoost/gravatar-component	1	1	0	2
4889980	mmm	https://github.com/m-m-m/mmm	1	1	0	2
4899072	b3log-symphony	https://github.com/b3log/b3log-symphony	1	1	0	2
4909355	cartodb	https://github.com/CartoDB/cartodb	1	2	0	3
4912314	datanommer	https://github.com/fedora-infra/datanommer	0	1	0	1
4916088	jdeclipse-realign	https://github.com/mchr3k/jdeclipse-realign	1	0	0	1
4926896	pywinrm	https://github.com/diyan/pywinrm	0	1	0	1
4927517	moloch	https://github.com/aol/moloch	1	1	0	2
4929418	google-calendar-crx	https://github.com/manastungare/google-calendar-crx	1	0	0	1
4929874	IOCextractor	https://github.com/stephenbrannon/IOCextractor	0	1	0	1
4931095	JavaFastPFOR	https://github.com/lemire/JavaFastPFOR	1	1	0	2
4934800	nap	https://github.com/jacobb/nap	0	5	0	5
4936749	feral-four	https://github.com/robjwells/feral-four	0	1	0	1
4939243	phantomas	https://github.com/macbre/phantomas	2	0	0	2
4949042	DeadTrees	https://github.com/jbeales/DeadTrees	0	1	0	1
4950433	init	https://github.com/drublic/init	0	2	0	2
4950987	mocha-as-promised	https://github.com/domenic/mocha-as-promised	1	0	0	1
4954003	JsSIP	https://github.com/versatica/JsSIP	0	1	0	1
4959563	zf2-documentation	https://github.com/zendframework/zf2-documentation	0	1	0	1
4967487	razor	https://github.com/cobub/razor	0	1	0	1
4972180	gallery	https://github.com/cmdjs/gallery	2	0	0	2
4973784	cycamore	https://github.com/cyclus/cycamore	1	0	0	1
4980324	onebusaway-application-modules	https://github.com/CUTR-at-USF/onebusaway-application-modules	0	4	0	4
4983184	Leaflet.markercluster	https://github.com/Leaflet/Leaflet.markercluster	1	0	0	1
4989235	iD	https://github.com/systemed/iD	0	1	0	1
4994614	wpscan	https://github.com/wpscanteam/wpscan	1	0	0	1
4994785	hexchat	https://github.com/hexchat/hexchat	1	1	0	2
5005340	mqttIO-objC	https://github.com/m2mIO/mqttIO-objC	1	0	0	1
5015065	MEIZU-ISSUES	https://github.com/khonsou/MEIZU-ISSUES	1	0	0	1
5047705	baosuzhai	https://github.com/hobos/baosuzhai	2	4	0	6
5051390	ost	https://github.com/lml/ost	1	1	0	2
5057307	terminal-notifier	https://github.com/alloy/terminal-notifier	0	1	0	1
5058412	angular-brunch-seed	https://github.com/scotch/angular-brunch-seed	0	1	0	1
5058928	phantomjs-gem	https://github.com/colszowka/phantomjs-gem	0	1	0	1
5061297	gistpress	https://github.com/bradyvercher/gistpress	1	1	0	2
5063050	red	https://github.com/friendica/red	2	0	0	2
5065219	yate-textmate	https://github.com/mctep/yate-textmate	1	0	0	1
5065618	selenese-runner-java	https://github.com/vmi/selenese-runner-java	0	1	0	1
5070321	bootstrap-glyphicons	https://github.com/marcoceppi/bootstrap-glyphicons	1	0	0	1
5072146	Tradesong	https://github.com/icbat/Tradesong	2	0	0	2
5076453	dialog	https://github.com/aralejs/dialog	1	1	0	2
5084750	PhotoView	https://github.com/chrisbanes/PhotoView	1	0	0	1
5090805	zombie	https://github.com/montchr/zombie	1	3	0	4
5094437	gridster.js	https://github.com/ducksboard/gridster.js	0	1	1	2
5095719	canadensys-data-access	https://github.com/Canadensys/canadensys-data-access	1	0	0	1
5099405	nemo	https://github.com/linuxmint/nemo	0	1	0	1
5101002	blog_engine	https://github.com/rathrio/blog_engine	2	0	0	2
5101141	jq	https://github.com/stedolan/jq	1	0	0	1
5101823	dashing	https://github.com/Shopify/dashing	1	1	1	3
5102117	EmulationStation	https://github.com/Aloshi/EmulationStation	1	0	0	1
5108836	COG	https://github.com/EarthSystemCoG/COG	0	1	0	1
5112553	abyss	https://github.com/globocom/abyss	2	2	0	4
5115347	intentionjs	https://github.com/dowjones/intentionjs	2	0	0	2
5129986	MacPass	https://github.com/mstarke/MacPass	0	3	0	3
5134592	fay	https://github.com/faylang/fay	2	0	0	2
5140927	webimageloader	https://github.com/lexs/webimageloader	1	0	0	1
5140943	OpenMaya	https://github.com/haggi/OpenMaya	4	6	0	10
5153143	rascal	https://github.com/cwi-swat/rascal	1	0	0	1
5154558	ofxOAuth	https://github.com/bakercp/ofxOAuth	5	1	0	6
5156526	litewrite	https://github.com/litewrite/litewrite	1	8	0	9
5164396	adhocracy.hhu_theme	https://github.com/hhucn/adhocracy.hhu_theme	1	4	0	5
5169847	syndication	https://github.com/Automattic/syndication	2	0	0	2
5171591	vbjs	https://github.com/shamrin/vbjs	1	1	0	2
5171841	beaver	https://github.com/josegonzalez/beaver	1	0	0	1
5174929	JSBadgeView	https://github.com/JaviSoto/JSBadgeView	1	0	0	1
5179144	scala-ide-play2	https://github.com/scala-ide/scala-ide-play2	1	0	0	1
5183474	controledecontas	https://github.com/renanigt/controledecontas	1	1	0	2
5183957	phansch.github.com	https://github.com/phansch/phansch.github.com	1	6	0	7
5193009	weiciyuan	https://github.com/qii/weiciyuan	1	2	0	3
5196951	srtracker	https://github.com/codeforamerica/srtracker	1	0	0	1
5201854	bugsnag-python	https://github.com/bugsnag/bugsnag-python	0	1	0	1
5201989	FinalStateAnalysis	https://github.com/uwcms/FinalStateAnalysis	0	1	0	1
5202266	php-ext-snappy	https://github.com/kjdev/php-ext-snappy	1	0	0	1
5211940	cmfive	https://github.com/careck/cmfive	0	1	0	1
5213091	bspwm	https://github.com/baskerville/bspwm	0	1	0	1
5214682	naonedbus	https://github.com/romainguefveneu/naonedbus	1	0	0	1
5224198	moocng	https://github.com/OpenMOOC/moocng	1	0	0	1
5227640	readable-wikipedia	https://github.com/nixterrimus/readable-wikipedia	1	0	0	1
5235734	ffmpeg-windows-build-helpers	https://github.com/rdp/ffmpeg-windows-build-helpers	0	1	0	1
5238231	www.html5rocks.com	https://github.com/html5rocks/www.html5rocks.com	3	1	0	4
5241176	ResqueBoard	https://github.com/kamisama/ResqueBoard	1	0	0	1
5241312	Halide	https://github.com/halide/Halide	1	1	0	2
5247655	carte-fluviale	https://github.com/yohanboniface/carte-fluviale	2	0	0	2
5248178	wp-bootstrap-navwalker	https://github.com/twittem/wp-bootstrap-navwalker	1	2	0	3
5248629	Intraclub	https://github.com/LennartMart/Intraclub	1	2	0	3
5250457	rcloud	https://github.com/cscheid/rcloud	3	0	0	3
5250779	OpenSlides	https://github.com/OpenSlides/OpenSlides	0	1	0	1
5253915	flaming-archer	https://github.com/jeremykendall/flaming-archer	3	1	0	4
5254138	puppet-jira	https://github.com/brycejohnson/puppet-jira	1	0	0	1
5254480	Prozess	https://github.com/cainus/Prozess	1	0	0	1
5254650	lumberjack	https://github.com/jordansissel/lumberjack	2	0	0	2
5259347	n98-magerun	https://github.com/netz98/n98-magerun	2	0	0	2
5262776	html-pipeline	https://github.com/jch/html-pipeline	1	1	0	2
5263633	sweet.js	https://github.com/mozilla/sweet.js	0	4	0	4
5266204	grunt-hub	https://github.com/shama/grunt-hub	1	1	0	2
5266284	chruby	https://github.com/postmodern/chruby	1	1	0	2
5269602	cpputest	https://github.com/cpputest/cpputest	1	0	0	1
5272963	framework	https://github.com/myak/framework	1	0	0	1
5274894	electrum	https://github.com/spesmilo/electrum	4	0	0	4
5275172	django-sis	https://github.com/burke-software/django-sis	2	0	0	2
5277124	Draffft	https://github.com/devxdev/Draffft	1	0	0	1
5279091	dagger	https://github.com/square/dagger	1	1	0	2
5279641	Sentry	https://github.com/jrbudda/Sentry	1	0	0	1
5281546	toolchain	https://github.com/openETCS/toolchain	2	16	0	18
5282596	cartopy	https://github.com/SciTools/cartopy	2	0	0	2
5284389	Crouton	https://github.com/keyboardsurfer/Crouton	0	1	0	1
5286344	Zaaksysteem	https://github.com/mintlab/Zaaksysteem	5	3	0	8
5291047	grunt-cucumber-js	https://github.com/s9tpepper/grunt-cucumber-js	0	3	0	3
5292082	gmail-filters	https://github.com/dvdt/gmail-filters	1	0	0	1
5293056	www.freedomsponsors.org	https://github.com/freedomsponsors/www.freedomsponsors.org	3	2	0	5
5295835	bedrock	https://github.com/aebsr/bedrock	1	0	0	1
5296230	cwtactics	https://github.com/ctomni231/cwtactics	0	1	0	1
5297437	pdf2htmlEX	https://github.com/coolwanglu/pdf2htmlEX	1	0	0	1
5297725	itempropwp	https://github.com/rolandinsh/itempropwp	1	0	0	1
5302158	RCLocationManager	https://github.com/rcabamo/RCLocationManager	0	1	0	1
5304003	uberspacify	https://github.com/yeah/uberspacify	1	0	0	1
5305368	MythTV-Service-API	https://github.com/MythTV-Clients/MythTV-Service-API	0	1	0	1
5310456	SpookyJS	https://github.com/WaterfallEngineering/SpookyJS	0	2	0	2
5315612	Citrus-Engine	https://github.com/alamboley/Citrus-Engine	1	0	0	1
5316449	ruby-lint	https://github.com/YorickPeterse/ruby-lint	0	1	0	1
5320077	optiq	https://github.com/julianhyde/optiq	1	1	0	2
5321315	crown	https://github.com/taylor001/crown	4	1	0	5
5323629	flapjack	https://github.com/ali-graham/flapjack	0	1	0	1
5325721	BackboneSeajsRESTphpapi	https://github.com/jinwyp/BackboneSeajsRESTphpapi	1	0	0	1
5326542	commonsense-python-lib	https://github.com/senseobservationsystems/commonsense-python-lib	1	1	0	2
5328133	JsonConfig	https://github.com/Dynalon/JsonConfig	0	1	0	1
5328171	bem-json	https://github.com/delfrrr/bem-json	1	0	0	1
5328565	FMElfinderBundle	https://github.com/helios-ag/FMElfinderBundle	0	1	0	1
5330407	adagios	https://github.com/opinkerfi/adagios	0	1	0	1
5332067	FluentScheduler	https://github.com/jgeurts/FluentScheduler	0	3	0	3
5338459	openstack-advanced-guide	https://github.com/eternaltyro/openstack-advanced-guide	1	0	0	1
5344375	textmate	https://github.com/textmate/textmate	2	2	0	4
5345981	mollisrv	https://github.com/pavel-shvetsov/mollisrv	1	1	0	2
5351666	nunjucks	https://github.com/jlongster/nunjucks	0	1	0	1
5358782	skuid	https://github.com/skuidify/skuid	1	0	0	1
5362444	F2	https://github.com/OpenF2/F2	1	0	0	1
5362812	builder.js	https://github.com/component/builder.js	1	0	0	1
5363235	component	https://github.com/component/component	1	1	0	2
5367290	mdk	https://github.com/FMCorz/mdk	0	3	0	3
5372136	observe-js	https://github.com/Polymer/observe-js	2	0	0	2
5379042	LinkLiar	https://github.com/halo/LinkLiar	0	1	0	1
5386653	push-notifications-sdk	https://github.com/shaders/push-notifications-sdk	1	0	0	1
5390156	fontforge	https://github.com/fontforge/fontforge	3	3	0	6
5391811	nexus-yum-plugin	https://github.com/sonatype/nexus-yum-plugin	0	1	0	1
5397873	justgage	https://github.com/toorshia/justgage	1	0	0	1
5405654	learnGitBranching	https://github.com/pcottle/learnGitBranching	2	1	0	3
5405957	activerecord_views	https://github.com/jasoncodes/activerecord_views	2	0	0	2
5409008	easyengine	https://github.com/rtCamp/easyengine	2	0	0	2
5412302	Meet-GavernWP	https://github.com/GavickPro/Meet-GavernWP	0	1	0	1
5414549	subsumption	https://github.com/cad-san/subsumption	1	0	0	1
5415150	hellomap3d	https://github.com/nutiteq/hellomap3d	2	1	0	3
5416410	mechanoid	https://github.com/robotoworks/mechanoid	1	0	0	1
5417266	ShowcaseView	https://github.com/Espiandev/ShowcaseView	0	1	0	1
5418669	BigVideo.js	https://github.com/dfcb/BigVideo.js	1	0	0	1
5431160	gridster.js	https://github.com/dustmoo/gridster.js	2	1	0	3
5434459	Ushahidi-plugin-sharing_two	https://github.com/rjmackay/Ushahidi-plugin-sharing_two	1	0	0	1
5438867	angular-google-maps	https://github.com/nlaplante/angular-google-maps	1	0	0	1
5440373	abf	https://github.com/cismet/abf	0	3	0	3
5441179	blackarch	https://github.com/BlackArch/blackarch	0	1	0	1
5446009	balanced-api	https://github.com/balanced/balanced-api	1	0	0	1
5446048	massr	https://github.com/tdtds/massr	0	0	1	1
5449546	ANNIS	https://github.com/korpling/ANNIS	2	0	0	2
5455013	toolchain	https://github.com/foss-for-synopsys-dwc-arc-processors/toolchain	0	1	0	1
5462499	wav2json	https://github.com/beschulz/wav2json	1	0	0	1
5467876	exread	https://github.com/dreampursuer/exread	0	1	0	1
5469084	node-shaper	https://github.com/sidorares/node-shaper	0	1	0	1
5483330	you-get	https://github.com/soimort/you-get	1	0	0	1
5484316	blend4j	https://github.com/jmchilton/blend4j	1	0	0	1
5485258	st2_pdf_panel	https://github.com/SunboX/st2_pdf_panel	0	1	0	1
5485915	FlansMod	https://github.com/FlansMods/FlansMod	0	4	0	4
5488210	mvc-metadata-conventions	https://github.com/Haacked/mvc-metadata-conventions	1	0	0	1
5490703	yobi	https://github.com/nforge/yobi	0	1	0	1
5492017	sidekiq_status	https://github.com/cryo28/sidekiq_status	0	1	0	1
5499321	nodeMongoQueries	https://github.com/victusfate/nodeMongoQueries	0	1	0	1
5505162	tecfiler	https://github.com/open-austin/tecfiler	1	1	0	2
5507135	www-cpants	https://github.com/charsbar/www-cpants	1	0	0	1
5508543	athena	https://github.com/SolusOS/athena	2	0	0	2
5508585	YOURLS	https://github.com/YOURLS/YOURLS	2	2	0	4
5509638	Shopify-Theme-Tool	https://github.com/meeech/Shopify-Theme-Tool	1	0	0	1
5526049	albacore	https://github.com/Albacore/albacore	0	2	0	2
5526899	Phoenix_1.12.1_Issue_tracker	https://github.com/FeenixServerProject/Phoenix_1.12.1_Issue_tracker	4	2	0	6
5527122	where-is-when-is	https://github.com/konekta/where-is-when-is	1	0	0	1
5528868	Android-Netrunner-OCTGN	https://github.com/db0/Android-Netrunner-OCTGN	1	1	0	2
5531424	ACE	https://github.com/cflowe/ACE	1	0	0	1
5532320	polymer	https://github.com/Polymer/polymer	3	3	0	6
5535611	Alkaline	https://github.com/jacobbudin/Alkaline	1	0	0	1
5540223	amazon-glacier-cmd-interface	https://github.com/uskudnik/amazon-glacier-cmd-interface	1	0	0	1
5542727	python-ftfy	https://github.com/LuminosoInsight/python-ftfy	0	2	0	2
5544923	httpotion	https://github.com/myfreeweb/httpotion	1	0	0	1
5550552	core	https://github.com/owncloud/core	6	2	2	10
5550556	apps	https://github.com/owncloud/apps	1	0	0	1
5550623	mirall	https://github.com/owncloud/mirall	3	5	0	8
5551732	daGrevis.lv	https://github.com/daGrevis/daGrevis.lv	2	7	0	9
5552858	cow	https://github.com/cyfdecyf/cow	1	3	0	4
5553394	vsm	https://github.com/inpho/vsm	1	0	0	1
5561238	gocql	https://github.com/tux21b/gocql	0	1	0	1
5568322	bayespy	https://github.com/bayespy/bayespy	0	1	0	1
5579081	vision_opencv	https://github.com/ros-perception/vision_opencv	0	1	1	2
5581947	PHFRefreshControl	https://github.com/fphilipe/PHFRefreshControl	1	0	0	1
5590286	dashboard	https://github.com/garden20/dashboard	1	0	0	1
5591636	ramona	https://github.com/ateska/ramona	3	2	0	5
5595825	durham-bike-coalition-	https://github.com/illmasterc/durham-bike-coalition-	1	0	0	1
5601299	encrypted-core-data	https://github.com/project-imas/encrypted-core-data	1	1	0	2
5604798	selectize.js	https://github.com/brianreavis/selectize.js	1	0	0	1
5609616	scripts	https://github.com/adlibre/scripts	1	0	0	1
5617495	co2r	https://github.com/Takingroot/co2r	1	0	0	1
5617672	ProMotion	https://github.com/clearsightstudio/ProMotion	1	0	0	1
5618793	GlobaLeaks	https://github.com/globaleaks/GlobaLeaks	1	0	0	1
5622204	BLM_Basic_Responsive	https://github.com/crondeau/BLM_Basic_Responsive	1	1	0	2
5625571	DAGMC	https://github.com/svalinn/DAGMC	5	1	0	6
5628934	gopher	https://github.com/jimmykuu/gopher	1	1	0	2
5629366	go-flags	https://github.com/jessevdk/go-flags	1	1	0	2
5631448	RestaurantOrderingApp	https://github.com/tgeary90/RestaurantOrderingApp	1	0	0	1
5631877	lsse	https://github.com/PomanoB/lsse	0	1	0	1
5632231	annotorious	https://github.com/annotorious/annotorious	1	0	0	1
5638565	Hilary	https://github.com/oaeproject/Hilary	0	1	0	1
5639802	android-menudrawer	https://github.com/SimonVT/android-menudrawer	0	2	0	2
5642413	relstorage	https://github.com/zodb/relstorage	1	0	0	1
5647712	Choron	https://github.com/tigrennatenn/Choron	1	0	0	1
5655908	VertNav	https://github.com/riconeitzel/VertNav	1	0	0	1
5657296	monolith	https://github.com/bigspring/monolith	1	0	0	1
5659923	tentd	https://github.com/tent/tentd	0	1	0	1
5662761	zeparser2	https://github.com/qfox/zeparser2	1	0	0	1
5678318	django-mysqlpool	https://github.com/smartfile/django-mysqlpool	1	0	0	1
5679888	Nocilla	https://github.com/luisobo/Nocilla	1	1	0	2
5685877	jqm4gwt	https://github.com/sksamuel/jqm4gwt	0	2	0	2
5690613	opam2web	https://github.com/OCamlPro/opam2web	1	2	0	3
5691059	moodle-mod_languagelab	https://github.com/oohoo/moodle-mod_languagelab	2	0	0	2
5691662	enketo	https://github.com/modilabs/enketo	6	11	0	17
5694937	two.js	https://github.com/jonobr1/two.js	1	1	0	2
5695275	glm	https://github.com/g-truc/glm	1	1	0	2
5706983	cs-studio	https://github.com/ControlSystemStudio/cs-studio	1	0	0	1
5708895	SenchaDraw	https://github.com/stephensaw/SenchaDraw	1	0	0	1
5709451	MySQLdb1	https://github.com/farcepest/MySQLdb1	0	1	0	1
5709657	romainberger.com	https://github.com/romainberger/romainberger.com	1	1	0	2
5718947	angular-strap	https://github.com/mgcrea/angular-strap	0	0	1	1
5720893	lif	https://github.com/rosedu/lif	1	0	0	1
5722110	jtransfo	https://github.com/joachimvda/jtransfo	0	3	0	3
5724990	Carbon	https://github.com/briannesbitt/Carbon	1	1	0	2
5727234	cortex	https://github.com/kaelzhang/cortex	1	1	0	2
5731348	obspy	https://github.com/obspy/obspy	1	0	0	1
5732998	ScnEsiWidget	https://github.com/SocalNick/ScnEsiWidget	1	0	0	1
5734809	parks-project	https://github.com/aaronlidman/parks-project	1	0	0	1
5737745	Tortuga	https://github.com/Ratstail91/Tortuga	0	2	0	2
5739328	OpenNMS-Android-Client	https://github.com/Tsukanov/OpenNMS-Android-Client	2	1	0	3
5740898	mylar	https://github.com/evilhero/mylar	2	62	0	64
5741125	ka-lite	https://github.com/learningequality/ka-lite	5	1	0	6
5745971	RobotML-SDK	https://github.com/RobotML/RobotML-SDK	1	0	0	1
5751170	tetra-ui	https://github.com/viadeo/tetra-ui	1	1	0	2
5755891	phantomjs	https://github.com/Obvious/phantomjs	1	2	0	3
5757727	Codiad	https://github.com/Codiad/Codiad	1	1	0	2
5760263	vimtouch	https://github.com/momodalo/vimtouch	2	0	0	2
5769372	app	https://github.com/kikinteractive/app	0	1	0	1
5771089	jquery.fullContent	https://github.com/zehfernandes/jquery.fullContent	1	0	0	1
5773635	onestep	https://github.com/happypeter/onestep	1	0	0	1
5783782	Anthill-Framework	https://github.com/AntKarlov/Anthill-Framework	1	0	0	1
5784827	JBAR-Firefox	https://github.com/rikai/JBAR-Firefox	1	0	0	1
5785039	JBAR-Chrome	https://github.com/rikai/JBAR-Chrome	1	1	0	2
5789105	RobotML	https://github.com/RobotML/RobotML	0	1	0	1
5790608	expm	https://github.com/yrashk/expm	1	0	0	1
5793121	chef-hello-cloud	https://github.com/karmi/chef-hello-cloud	0	1	0	1
5793510	winforms-modernui	https://github.com/viperneo/winforms-modernui	1	1	0	2
5793976	mDn-Mobile	https://github.com/jonyeunghk/mDn-Mobile	3	4	0	7
5794776	MOPCON	https://github.com/MOPCON/MOPCON	3	2	0	5
5799800	c18h27no3	https://github.com/rookies/c18h27no3	0	1	0	1
5800709	loris	https://github.com/pulibrary/loris	1	0	0	1
5801193	api	https://github.com/rdio/api	0	1	0	1
5801918	brackets-edge-web-fonts	https://github.com/adobe/brackets-edge-web-fonts	1	0	0	1
5803599	backbone.stickit	https://github.com/NYTimes/backbone.stickit	1	0	0	1
5806020	mtools	https://github.com/rueckstiess/mtools	4	2	0	6
5806776	moveit_ros	https://github.com/ros-planning/moveit_ros	1	0	0	1
5811097	jasno	https://github.com/janpecha/jasno	1	0	0	1
5811699	Moxie	https://github.com/hmeza/Moxie	1	0	0	1
5816879	former	https://github.com/Anahkiasen/former	2	0	0	2
5820654	vr-lect	https://github.com/icosaeder/vr-lect	1	0	0	1
5826662	White	https://github.com/TestStack/White	1	0	0	1
5831189	hoek	https://github.com/spumko/hoek	0	1	0	1
5840173	anim_encoder	https://github.com/sublimehq/anim_encoder	1	0	0	1
5840627	crowdguru	https://github.com/crowdguru/crowdguru	4	0	0	4
5842155	Tanlinell	https://github.com/getdave/Tanlinell	6	7	0	13
5845768	grunt-contrib-sass	https://github.com/gruntjs/grunt-contrib-sass	2	0	0	2
5847275	grunt-contrib-watch	https://github.com/gruntjs/grunt-contrib-watch	2	1	0	3
5850234	libmesh	https://github.com/libMesh/libmesh	1	0	0	1
5853229	angular-leaflet-directive	https://github.com/tombatossals/angular-leaflet-directive	1	0	0	1
5856481	nginx-helper	https://github.com/rtCamp/nginx-helper	1	1	0	2
5857306	heroku-django-cookbook	https://github.com/nigma/heroku-django-cookbook	1	0	0	1
5857387	jedi-vim	https://github.com/davidhalter/jedi-vim	1	1	0	2
5865694	npmrc	https://github.com/deoxxa/npmrc	1	0	0	1
5872891	oltpbench	https://github.com/oltpbenchmark/oltpbench	2	0	0	2
5875642	YiiBooster	https://github.com/clevertech/YiiBooster	0	2	0	2
5880912	pomelo	https://github.com/NetEase/pomelo	1	0	0	1
5882412	Relax	https://github.com/zachelrath/Relax	1	0	0	1
5893828	oauth2-server-php	https://github.com/bshaffer/oauth2-server-php	1	1	0	2
5898778	DAS	https://github.com/vidma/DAS	4	4	0	8
5912151	EmptyConstructor	https://github.com/Fody/EmptyConstructor	0	1	0	1
5914996	vanilla	https://github.com/adrian-bl/vanilla	1	0	0	1
5918561	jquery-simple-slider	https://github.com/loopj/jquery-simple-slider	1	0	0	1
5919188	easyloggingpp	https://github.com/easylogging/easyloggingpp	0	4	0	4
5922099	portfoliojs	https://github.com/abhiomkar/portfoliojs	1	0	0	1
5923215	hexo	https://github.com/tommy351/hexo	0	1	0	1
5924734	howitzer	https://github.com/romikoops/howitzer	1	0	0	1
5925251	dox-foundation	https://github.com/punkave/dox-foundation	1	0	0	1
5925311	adhocracy	https://github.com/liqd/adhocracy	1	0	0	1
5925629	grunt-jsdoc-plugin	https://github.com/krampstudio/grunt-jsdoc-plugin	0	1	0	1
5928014	Leaflet.label	https://github.com/Leaflet/Leaflet.label	1	0	0	1
5932007	turtlebot_apps	https://github.com/turtlebot/turtlebot_apps	1	0	0	1
5932749	acorn	https://github.com/marijnh/acorn	1	1	0	2
5934517	kafka-python	https://github.com/mumrah/kafka-python	0	2	0	2
5946691	easyssl	https://github.com/thonixx/easyssl	2	4	0	6
5950057	fubu	https://github.com/DarthFubuMVC/fubu	1	0	0	1
5957708	summingbird	https://github.com/twitter/summingbird	1	0	0	1
5958282	couchbase-ruby-model	https://github.com/couchbase/couchbase-ruby-model	1	0	0	1
5959646	trema-edge	https://github.com/trema/trema-edge	0	1	0	1
5967328	fluent-plugin-tail-ex	https://github.com/yosisa/fluent-plugin-tail-ex	1	0	0	1
5972219	bootstrap-select	https://github.com/silviomoreto/bootstrap-select	3	1	0	4
5973855	Cataclysm-DDA	https://github.com/CleverRaven/Cataclysm-DDA	7	4	0	11
5975139	pyrax	https://github.com/rackspace/pyrax	2	1	0	3
5978320	sns-router	https://github.com/hupili/sns-router	0	2	0	2
5978331	macfusion2	https://github.com/ElDeveloper/macfusion2	1	0	0	1
5979499	flowplayer	https://github.com/flowplayer/flowplayer	1	1	0	2
5980909	infoscoop	https://github.com/infoScoop/infoscoop	2	0	0	2
5987523	doxmate	https://github.com/JacksonTian/doxmate	0	1	0	1
5987636	puppetctl	https://github.com/mozilla-it/puppetctl	1	0	0	1
5993416	STTwitter	https://github.com/nst/STTwitter	0	1	0	1
5995031	ServiceMatrix	https://github.com/Particular/ServiceMatrix	0	1	0	1
5995904	turbo-sprockets-rails3	https://github.com/ndbroadbent/turbo-sprockets-rails3	1	0	0	1
5996177	replify	https://github.com/dshaw/replify	2	0	0	2
5999237	grunt-ember-templates	https://github.com/dgeb/grunt-ember-templates	1	1	0	2
6001800	openboxes	https://github.com/PIH/openboxes	1	0	0	1
6009785	webjars	https://github.com/webjars/webjars	1	0	0	1
6011756	DarkRP	https://github.com/FPtje/DarkRP	2	0	0	2
6013572	SNPSVM	https://github.com/brendanofallon/SNPSVM	1	0	0	1
6015874	boxen	https://github.com/boxen/boxen	0	1	0	1
6017957	cafe	https://github.com/EugeneN/cafe	1	0	0	1
6018162	edx-downloader	https://github.com/shk3/edx-downloader	0	1	0	1
6018772	dataflow	https://github.com/meemoo/dataflow	1	0	0	1
6020976	alg-lister	https://github.com/justinj/alg-lister	1	0	0	1
6025193	JSCover	https://github.com/tntim96/JSCover	1	0	0	1
6025443	textmetal	https://github.com/dpbullington/textmetal	6	5	0	11
6028011	silver	https://github.com/oleq/silver	1	0	0	1
6031304	diametric	https://github.com/relevance/diametric	1	0	0	1
6031624	Auryn	https://github.com/rdlowrey/Auryn	0	5	0	5
6032589	ajaxplorer-core	https://github.com/ajaxplorer/ajaxplorer-core	0	3	0	3
6032644	AnyEvent-Open3-Simple	https://github.com/plicease/AnyEvent-Open3-Simple	1	0	0	1
6032809	croppa	https://github.com/BKWLD/croppa	1	0	0	1
6052702	puppet-nodejs	https://github.com/boxen/puppet-nodejs	1	0	0	1
6053328	RSSClient	https://github.com/desarrolla2/RSSClient	1	0	0	1
6054246	silverstripe-dashboard	https://github.com/unclecheese/silverstripe-dashboard	0	1	0	1
6054784	dipscheck	https://github.com/jeffbonnes/dipscheck	0	1	0	1
6059821	Starling-Extension-Graphics	https://github.com/StarlingGraphics/Starling-Extension-Graphics	1	0	0	1
6063617	BarcodeScanner	https://github.com/wildabeast/BarcodeScanner	1	0	0	1
6064643	Sandbox	https://github.com/adlnet/Sandbox	1	1	1	3
6066709	georchestra	https://github.com/georchestra/georchestra	11	5	0	16
6067307	MultiWii_EZ_GUI	https://github.com/eziosoft/MultiWii_EZ_GUI	0	2	0	2
6069712	HalloweenBash	https://github.com/xta/HalloweenBash	1	1	0	2
6072548	OvermonAdminTools	https://github.com/highfeeling/OvermonAdminTools	2	2	0	4
6073079	CliqrPlugin	https://github.com/luniki/CliqrPlugin	4	1	0	5
6073086	tendo	https://github.com/pycontribs/tendo	0	1	0	1
6073983	ASDepthModal	https://github.com/autresphere/ASDepthModal	2	0	0	2
6076904	perception_pcl	https://github.com/ros-perception/perception_pcl	1	0	0	1
6077235	gmailr	https://github.com/joscha/gmailr	1	0	0	1
6077473	curl	https://github.com/hackerone/curl	1	1	0	2
6080193	li3_redis	https://github.com/bruensicke/li3_redis	0	1	0	1
6080978	rSENSE	https://github.com/isenseDev/rSENSE	0	1	0	1
6082996	sync_gateway	https://github.com/couchbase/sync_gateway	0	1	0	1
6083095	vampire	https://github.com/richard-evans/vampire	1	0	0	1
6084210	BungeeCord	https://github.com/SpigotMC/BungeeCord	2	4	0	6
6085331	Kethane	https://github.com/Majiir/Kethane	0	1	0	1
6087301	esup-opi	https://github.com/EsupPortail/esup-opi	0	1	0	1
6091438	Team-Project--Q	https://github.com/Dan-McElroy/Team-Project--Q	0	3	0	3
6092753	jQueryFormStyler	https://github.com/Dimox/jQueryFormStyler	1	0	0	1
6092896	angular.tree	https://github.com/dump247/angular.tree	1	0	0	1
6093316	DefinitelyTyped	https://github.com/borisyankov/DefinitelyTyped	2	0	0	2
6093450	python-matlab-bridge	https://github.com/arokem/python-matlab-bridge	1	0	0	1
6094683	bootstrap	https://github.com/angular-ui/bootstrap	6	2	0	8
6098283	snowdrift	https://github.com/dlthomas/snowdrift	2	1	0	3
6098787	IATI-Implementation-Schedules	https://github.com/markbrough/IATI-Implementation-Schedules	1	0	0	1
6106460	jquery.cssanimate.js	https://github.com/after12am/jquery.cssanimate.js	1	1	0	2
6111046	cask	https://github.com/cask/cask	0	1	0	1
6118575	fontcustom	https://github.com/FontCustom/fontcustom	1	0	0	1
6123437	jsystem	https://github.com/Top-Q/jsystem	1	0	0	1
6126322	Treecapitator	https://github.com/bspkrs/Treecapitator	1	0	0	1
6134673	canari	https://github.com/allfro/canari	1	0	0	1
6142030	qloudsync	https://github.com/greenqloud/qloudsync	1	0	0	1
6149090	sbt	https://github.com/gkossakowski/sbt	6	0	0	6
6151526	weibo_ios_sdk_sso-oauth	https://github.com/mobileresearch/weibo_ios_sdk_sso-oauth	1	0	0	1
6154653	gitlab-ci	https://github.com/gitlabhq/gitlab-ci	1	0	0	1
6160673	ZXing.Net.Mobile	https://github.com/Redth/ZXing.Net.Mobile	1	0	0	1
6181097	minimapper	https://github.com/joakimk/minimapper	1	0	0	1
6181639	bxslider-4	https://github.com/wandoledzep/bxslider-4	1	0	0	1
6198699	ng-grid	https://github.com/angular-ui/ng-grid	3	2	0	5
6199519	theSloth	https://github.com/ehedaya/theSloth	1	1	0	2
6200069	launchpad	https://github.com/ekryski/launchpad	1	0	0	1
6201092	mpv	https://github.com/mpv-player/mpv	1	0	0	1
6203428	nw-sample-apps	https://github.com/zcbenz/nw-sample-apps	1	0	0	1
6204918	hashids.rb	https://github.com/peterhellberg/hashids.rb	1	0	0	1
6209952	qiime	https://github.com/qiime/qiime	1	1	0	2
6216713	automx	https://github.com/sys4/automx	1	0	0	1
6217301	wikisource2mobi	https://github.com/macbre/wikisource2mobi	1	0	0	1
6220644	OpenRefine	https://github.com/OpenRefine/OpenRefine	1	0	0	1
6223866	rose	https://github.com/metomi/rose	0	1	0	1
6224372	streck	https://github.com/urdh/streck	0	1	0	1
6224898	ClickableUrls_SublimeText2	https://github.com/leonid-shevtsov/ClickableUrls_SublimeText2	1	0	0	1
6228245	service-documents	https://github.com/laclasse-com/service-documents	0	1	0	1
6228403	easybuild-easyconfigs	https://github.com/hpcugent/easybuild-easyconfigs	1	0	0	1
6230771	farmshares	https://github.com/RealFilling/farmshares	0	1	0	1
6234378	jquery-visible	https://github.com/teamdf/jquery-visible	0	1	0	1
6248212	heka	https://github.com/mozilla-services/heka	4	2	0	6
6248414	ripple-client	https://github.com/ripple/ripple-client	1	0	0	1
6251097	emacs-jedi	https://github.com/tkf/emacs-jedi	3	0	0	3
6257856	openfoodweb	https://github.com/eaterprises/openfoodweb	4	2	0	6
6258358	open-shot	https://github.com/hasadna/open-shot	12	5	0	17
6261032	features	https://github.com/woothemes/features	1	1	0	2
6266585	schemas	https://github.com/MAECProject/schemas	1	0	0	1
6267158	strider	https://github.com/Strider-CD/strider	3	1	0	4
6268419	isso	https://github.com/posativ/isso	1	1	0	2
6270010	nb-yii-plugin	https://github.com/nbphpcouncil/nb-yii-plugin	1	0	0	1
6274605	Citadel	https://github.com/erocs/Citadel	1	2	0	3
6274806	pocket-survey	https://github.com/sosandstrom/pocket-survey	1	0	0	1
6274969	socketstream-0.4	https://github.com/socketstream/socketstream-0.4	1	0	0	1
6275857	resharper-nuget	https://github.com/JetBrains/resharper-nuget	1	0	0	1
6279059	MagentoCustomizePriceFilter	https://github.com/aurmil/MagentoCustomizePriceFilter	0	1	0	1
6283269	Watch.JS	https://github.com/melanke/Watch.JS	0	1	0	1
6284847	floobits-sublime	https://github.com/Floobits/floobits-sublime	1	0	0	1
6287585	PocketMine-MP	https://github.com/PocketMine/PocketMine-MP	2	1	0	3
6288441	ckanext-mongodb	https://github.com/alexbyrnes/ckanext-mongodb	1	0	0	1
6295999	zenphoto	https://github.com/zenphoto/zenphoto	0	1	0	1
6300351	Bungloo	https://github.com/jeena/Bungloo	1	12	0	13
6300427	ShareFest	https://github.com/Peer5/ShareFest	2	3	0	5
6304876	Test-Kwalitee-Extra	https://github.com/yak1ex/Test-Kwalitee-Extra	2	2	0	4
6305945	rosserial	https://github.com/ros-drivers/rosserial	1	0	0	1
6309879	beeswarm	https://github.com/honeynet/beeswarm	3	0	0	3
6315924	twbudget	https://github.com/g0v/twbudget	2	2	0	4
6315931	javafx-maven-plugin	https://github.com/zonski/javafx-maven-plugin	1	0	0	1
6323606	xbian	https://github.com/xbianonpi/xbian	1	1	0	2
6327152	git	https://github.com/felipec/git	1	0	0	1
6328209	NetCommons3	https://github.com/ryu818/NetCommons3	2	1	1	4
6339911	vim-tags	https://github.com/szw/vim-tags	1	0	0	1
6346530	WGS2Mars	https://github.com/shenqiliang/WGS2Mars	1	0	0	1
6349954	lingpy	https://github.com/lingpy/lingpy	2	0	0	2
6350340	F3	https://github.com/ferstaberinde/F3	1	2	0	3
6353031	parallel_http	https://github.com/yuya-takeyama/parallel_http	1	0	0	1
6354349	sdk-java	https://github.com/schibsted/sdk-java	0	1	0	1
6354887	custard	https://github.com/scraperwiki/custard	1	2	0	3
6358793	Xamarin.Auth	https://github.com/xamarin/Xamarin.Auth	1	0	0	1
6359139	tutorials.gsapp.org	https://github.com/columbiagsapp/tutorials.gsapp.org	0	2	0	2
6368218	PyMarkovChain	https://github.com/MaxWagner/PyMarkovChain	2	0	0	2
6376337	poco	https://github.com/pocoproject/poco	1	2	0	3
6383665	Desktop	https://github.com/Docear/Desktop	1	0	0	1
6388310	picons	https://github.com/ocram/picons	3	3	0	6
6392868	gochimp	https://github.com/mattbaird/gochimp	1	0	0	1
6396988	adaptivepayments-sdk-dotnet	https://github.com/paypal/adaptivepayments-sdk-dotnet	1	0	0	1
6404963	blaze	https://github.com/ContinuumIO/blaze	1	1	0	2
6405017	griddler	https://github.com/thoughtbot/griddler	0	1	0	1
6405764	RazorPDF	https://github.com/RazorAnt/RazorPDF	1	0	0	1
6411723	sell-media	https://github.com/graphpaperpress/sell-media	2	3	0	5
6413365	stately	https://github.com/rtwomey/stately	0	2	0	2
6423829	AdditionalPipesBC	https://github.com/tcooc/AdditionalPipesBC	0	1	0	1
6431638	sticky-notes	https://github.com/sayakb/sticky-notes	0	1	0	1
6432563	python-paddingoracle	https://github.com/mwielgoszewski/python-paddingoracle	1	0	0	1
6435042	QtAV	https://github.com/wang-bin/QtAV	0	1	0	1
6441855	grunt-contrib-imagemin	https://github.com/gruntjs/grunt-contrib-imagemin	2	1	0	3
6441869	grunt-contrib-htmlmin	https://github.com/gruntjs/grunt-contrib-htmlmin	1	0	0	1
6441969	spring-restbucks	https://github.com/olivergierke/spring-restbucks	1	0	0	1
6443993	unplugged-controls	https://github.com/unplugged/unplugged-controls	1	2	1	4
6446846	excel2latex	https://github.com/eric-wood/excel2latex	1	0	0	1
6448114	node-phonegap-build-api	https://github.com/phonegap/node-phonegap-build-api	1	1	0	2
6452529	rethinkdb	https://github.com/rethinkdb/rethinkdb	1	2	0	3
6454760	Axel	https://github.com/xgouchet/Axel	1	0	0	1
6458557	Bear	https://github.com/rizsotto/Bear	1	0	1	2
6459097	opportunity	https://github.com/kern3020/opportunity	1	1	0	2
6466760	tmTheme-Editor	https://github.com/aziz/tmTheme-Editor	1	0	0	1
6470655	dub	https://github.com/rejectedsoftware/dub	3	1	0	4
6474647	casadi	https://github.com/casadi/casadi	2	1	0	3
6475854	vle	https://github.com/vle-forge/vle	1	2	0	3
6476959	sweble-wikitext	https://github.com/sweble/sweble-wikitext	0	1	0	1
6477953	instafeed.js	https://github.com/stevenschobert/instafeed.js	0	1	0	1
6479425	rendr	https://github.com/airbnb/rendr	0	1	0	1
6480286	macroTable	https://github.com/chainsawsalad/macroTable	1	4	0	5
6481043	OSCAAR	https://github.com/OSCAAR/OSCAAR	0	1	0	1
6486826	ppsspp	https://github.com/hrydgard/ppsspp	5	5	0	10
6494728	grunt-cli	https://github.com/gruntjs/grunt-cli	1	0	0	1
6495967	arduino-rtttl-player	https://github.com/ponty/arduino-rtttl-player	0	1	0	1
6496325	apps.fp.o	https://github.com/fedora-infra/apps.fp.o	1	0	0	1
6500041	infovore	https://github.com/paulhoule/infovore	1	0	0	1
6502093	openclassifieds2	https://github.com/open-classifieds/openclassifieds2	1	0	0	1
6505724	GetSimpleCMS	https://github.com/GetSimpleCMS/GetSimpleCMS	0	0	1	1
6506651	azure-sdk-tools-xplat	https://github.com/WindowsAzure/azure-sdk-tools-xplat	1	0	0	1
6506813	Gamification	https://github.com/mattSOLANO/Gamification	1	0	0	1
6508031	openxc-python	https://github.com/openxc/openxc-python	2	0	0	2
6508378	Chrome-Basecamp-Notifier	https://github.com/samuelsimoes/Chrome-Basecamp-Notifier	1	2	0	3
6509783	nfs-ganesha	https://github.com/nfs-ganesha/nfs-ganesha	0	1	0	1
6512474	roundtablecrm	https://github.com/davesouth/roundtablecrm	0	1	0	1
6513478	ti-yet-another-slider-menu	https://github.com/jeffbonnes/ti-yet-another-slider-menu	1	1	0	2
6515810	entrada-1x	https://github.com/EntradaProject/entrada-1x	1	2	0	3
6517512	openHEVC	https://github.com/OpenHEVC/openHEVC	1	2	0	3
6522908	spike	https://github.com/Hudon/spike	1	0	0	1
6523023	yowsup	https://github.com/tgalal/yowsup	1	0	0	1
6523976	training.python_web	https://github.com/cewing/training.python_web	1	0	0	1
6530075	history	https://github.com/arvgta/history	2	0	0	2
6530634	leaflet-locatecontrol	https://github.com/domoritz/leaflet-locatecontrol	0	2	1	3
6533164	gephi-plugins	https://github.com/oxfordinternetinstitute/gephi-plugins	2	0	0	2
6536711	sharedy	https://github.com/skddc/sharedy	1	0	0	1
6538619	Sazare	https://github.com/devlights/Sazare	0	1	0	1
6551865	jquery-number	https://github.com/teamdf/jquery-number	1	1	0	2
6552023	bart	https://github.com/dfm/bart	3	27	0	30
6556815	seahub	https://github.com/haiwen/seahub	0	1	0	1
6558262	plugin-update-checker	https://github.com/YahnisElsts/plugin-update-checker	0	1	0	1
6568554	valuenetwork	https://github.com/valnet/valuenetwork	1	0	0	1
6577150	lua-MessagePack	https://github.com/fperrad/lua-MessagePack	1	1	0	2
6580000	robomongo	https://github.com/paralect/robomongo	2	0	0	2
6581055	ekanban	https://github.com/samchen2009/ekanban	1	0	0	1
6585099	littlego	https://github.com/herzbube/littlego	6	2	0	8
6585639	fuel	https://github.com/lokidokicoki/fuel	6	0	0	6
6589168	TauLabs	https://github.com/TauLabs/TauLabs	0	1	0	1
6600823	jzmq-support	https://github.com/artem-v/jzmq-support	3	0	0	3
6602323	bignumber.js	https://github.com/MikeMcl/bignumber.js	1	0	0	1
6603841	course_tree_list	https://github.com/jayhuber/course_tree_list	0	1	0	1
6604158	ENdoSnipe	https://github.com/endosnipe/ENdoSnipe	2	0	0	2
6604361	mdtraj	https://github.com/rmcgibbo/mdtraj	1	0	0	1
6610589	chunky	https://github.com/llbit/chunky	2	1	0	3
6614385	PyMP	https://github.com/mmoussallam/PyMP	1	2	0	3
6614502	unity-doc	https://github.com/unity3d-jp/unity-doc	0	1	0	1
6617845	pdf2json	https://github.com/modesty/pdf2json	0	1	0	1
6617984	Phue	https://github.com/sqmk/Phue	0	1	0	1
6619192	Distributions.jl	https://github.com/JuliaStats/Distributions.jl	1	0	0	1
6621471	dash.js	https://github.com/Dash-Industry-Forum/dash.js	0	2	0	2
6622209	twitter-streamer	https://github.com/inactivist/twitter-streamer	1	1	0	2
6625369	truncato	https://github.com/jorgemanrubia/truncato	1	0	0	1
6626356	wanggit	https://github.com/wangframe/wanggit	1	0	0	1
6627106	DZCP-Extended-Edition	https://github.com/Hammermaps-DEV/DZCP-Extended-Edition	0	1	0	1
6628464	dotfiles	https://github.com/koheisg/dotfiles	1	1	0	2
6632931	nzbToMedia	https://github.com/clinton-hall/nzbToMedia	1	0	0	1
6633797	HDSAC	https://github.com/denoflionsx/HDSAC	1	0	0	1
6636200	virgen-acl	https://github.com/djvirgen/virgen-acl	1	1	0	2
6648028	PyBitmessage	https://github.com/Bitmessage/PyBitmessage	1	1	0	2
6651735	battlemesh-packages	https://github.com/battlemesh/battlemesh-packages	1	1	0	2
6652435	zombot	https://github.com/Vanuan/zombot	1	0	0	1
6656911	stripe-ios	https://github.com/stripe/stripe-ios	0	2	0	2
6659201	rss2email	https://github.com/wking/rss2email	0	2	0	2
6659216	Laravel-Administrator	https://github.com/FrozenNode/Laravel-Administrator	1	0	0	1
6660366	dompdf	https://github.com/dompdf/dompdf	1	1	0	2
6660536	uvcdat	https://github.com/UV-CDAT/uvcdat	0	2	0	2
6662696	BrockAllen.MembershipReboot	https://github.com/brockallen/BrockAllen.MembershipReboot	1	0	0	1
6663589	FunScript	https://github.com/ZachBray/FunScript	1	0	0	1
6665365	kal	https://github.com/rzimmerman/kal	3	4	0	7
6665626	Stino	https://github.com/Robot-Will/Stino	1	0	0	1
6667523	scripler	https://github.com/Scripler/scripler	0	1	0	1
6668792	turnierApp	https://github.com/DanielMSchmidt/turnierApp	2	0	0	2
6687522	dspdfviewer	https://github.com/dannyedel/dspdfviewer	0	1	0	1
6689967	breakbot	https://github.com/stenyak/breakbot	0	1	0	1
6691560	mimosa-combine	https://github.com/dbashford/mimosa-combine	1	1	0	2
6697439	gaia-ui-tests	https://github.com/mozilla/gaia-ui-tests	2	0	0	2
6698407	pyret-lang	https://github.com/brownplt/pyret-lang	1	0	0	1
6702868	markerclustererplus	https://github.com/mahnunchik/markerclustererplus	1	0	0	1
6707453	openstreetmap-carto	https://github.com/gravitystorm/openstreetmap-carto	1	0	0	1
6707912	congress-ios	https://github.com/sunlightlabs/congress-ios	3	2	1	6
6714787	pickadate.js	https://github.com/amsul/pickadate.js	3	1	0	4
6723399	wordpress-seo	https://github.com/Yoast/wordpress-seo	1	0	0	1
6726834	acralyzer	https://github.com/ACRA/acralyzer	1	0	0	1
6729631	JamomaCore	https://github.com/jamoma/JamomaCore	1	0	0	1
6730370	FsRandom	https://github.com/kos59125/FsRandom	2	2	0	4
6732980	grip	https://github.com/joeyespo/grip	1	0	0	1
6738319	novice	https://github.com/synesthesiam/novice	1	0	0	1
6739501	aerotools-ng	https://github.com/lynix/aerotools-ng	0	1	0	1
6748497	lammps-netcdf	https://github.com/pastewka/lammps-netcdf	1	0	0	1
6749378	hoodie-server	https://github.com/hoodiehq/hoodie-server	0	4	0	4
6750295	innerhearth	https://github.com/decitrig/innerhearth	1	1	0	2
6750743	portail	https://github.com/simde-utc/portail	2	1	0	3
6753716	modal-box	https://github.com/tkirda/modal-box	1	0	0	1
6753728	liteide	https://github.com/visualfc/liteide	1	0	0	1
6755841	django-xadmin	https://github.com/sshwsfc/django-xadmin	1	1	0	2
6757667	statuses	https://github.com/innoq/statuses	0	1	0	1
6760343	soa-model	https://github.com/membrane/soa-model	5	1	0	6
6761380	x-editable	https://github.com/vitalets/x-editable	3	0	0	3
6767526	Battery	https://github.com/Goles/Battery	1	0	0	1
6773893	HealCalc3	https://github.com/skiadas/HealCalc3	1	0	0	1
6774213	FIND	https://github.com/PoPoutdoor/FIND	1	0	0	1
6779831	multiple-content-blocks	https://github.com/trendwerk/multiple-content-blocks	1	0	0	1
6780534	StudIPAndroidApp	https://github.com/elan-ev/StudIPAndroidApp	1	1	0	2
6780767	aws-cli	https://github.com/aws/aws-cli	4	1	0	5
6785729	SCOPE	https://github.com/JDShu/SCOPE	1	0	0	1
6786143	cats	https://github.com/jbaron/cats	3	2	0	5
6787544	JamomaMax	https://github.com/jamoma/JamomaMax	0	1	0	1
6795605	wiselinks	https://github.com/igor-alexandrov/wiselinks	1	1	0	2
6798789	soapower	https://github.com/soapower/soapower	0	2	0	2
6799283	xoi	https://github.com/kbroman/xoi	1	0	0	1
6804324	generator-angular	https://github.com/yeoman/generator-angular	2	1	0	3
6804779	generator-webapp	https://github.com/yeoman/generator-webapp	2	1	0	3
6806135	libbmd	https://github.com/lu-zero/libbmd	1	0	0	1
6806252	aodn-portal	https://github.com/aodn/aodn-portal	2	0	0	2
6806722	plugin.video.globotv	https://github.com/vitorhirota/plugin.video.globotv	0	1	0	1
6807979	dnd-teaser	https://github.com/easi6/dnd-teaser	1	3	0	4
6809499	treeIt	https://github.com/alessioalex/treeIt	0	1	0	1
6816757	webrtc-docs	https://github.com/openRMC/webrtc-docs	1	0	0	1
6817247	hidetopbar	https://github.com/mlutfy/hidetopbar	1	0	0	1
6818050	newrelic_platform_plugins	https://github.com/railsware/newrelic_platform_plugins	1	0	0	1
6822038	ARP-Defense	https://github.com/alan-reed/ARP-Defense	1	0	0	1
6822358	gitprep	https://github.com/yuki-kimoto/gitprep	0	1	0	1
6825724	requests-oauthlib	https://github.com/requests/requests-oauthlib	1	0	0	1
6825820	biosual	https://github.com/4ndr01d3/biosual	1	0	0	1
6844761	sinatra_cyclist	https://github.com/vrish88/sinatra_cyclist	1	0	0	1
6851897	Star-Wars-LCG-OCTGN	https://github.com/db0/Star-Wars-LCG-OCTGN	1	0	0	1
6854838	Universal-G-Code-Sender	https://github.com/grbl/Universal-G-Code-Sender	1	0	0	1
6862780	djangocms-text-ckeditor	https://github.com/divio/djangocms-text-ckeditor	0	1	0	1
6869900	webapp	https://github.com/VertNet/webapp	4	2	0	6
6872992	steroids	https://github.com/AppGyver/steroids	0	2	1	3
6876313	TheGaffer	https://github.com/MCME/TheGaffer	1	0	0	1
6878512	eFacturaT	https://github.com/jccastillo0007/eFacturaT	1	1	0	2
6884692	android-comboseekbar	https://github.com/karabaralex/android-comboseekbar	1	0	0	1
6887813	crystal	https://github.com/manastech/crystal	0	1	0	1
6889426	node-manta	https://github.com/joyent/node-manta	1	1	0	2
6890198	ember-localstorage-adapter	https://github.com/rpflorence/ember-localstorage-adapter	1	1	0	2
6890444	quickQuestion	https://github.com/Dica-Developer/quickQuestion	11	2	0	13
6890589	etsyapi	https://github.com/etsy/etsyapi	1	0	0	1
6892935	coveralls-public	https://github.com/lemurheavy/coveralls-public	1	3	1	5
6902605	licode	https://github.com/ging/licode	1	1	0	2
6903016	Palmer	https://github.com/MitchDenny/Palmer	1	0	0	1
6908841	mfiddle	https://github.com/montagejs/mfiddle	1	0	0	1
6910286	salt-bootstrap	https://github.com/saltstack/salt-bootstrap	0	1	0	1
6911130	habitrpg-mobile	https://github.com/HabitRPG/habitrpg-mobile	1	3	0	4
6911410	Redux-Framework	https://github.com/ghost1227/Redux-Framework	0	22	0	22
6913116	eggbox	https://github.com/hatchddigital/eggbox	1	0	0	1
6922133	ctlweb	https://github.com/ctldev/ctlweb	2	2	0	4
6924985	icph	https://github.com/joshreisner/icph	1	1	0	2
6931044	wp-session-manager	https://github.com/ericmann/wp-session-manager	0	1	0	1
6941080	piecemaker2-api	https://github.com/motionbank/piecemaker2-api	1	5	0	6
6945895	grunt-imagemagick	https://github.com/icagstrout/grunt-imagemagick	1	0	0	1
6955002	bauble2	https://github.com/Bauble/bauble2	1	0	0	1
6956141	feedme	https://github.com/struan/feedme	1	0	0	1
6966619	hawtio	https://github.com/hawtio/hawtio	4	5	0	9
6969835	JSONModel	https://github.com/icanzilb/JSONModel	1	0	0	1
6973595	clj-gapi	https://github.com/ianbarber/clj-gapi	0	1	0	1
6973819	avare	https://github.com/apps4av/avare	1	0	0	1
6973917	arti_mark	https://github.com/skoji/arti_mark	2	0	0	2
6978492	cshc_website	https://github.com/cshc/cshc_website	1	4	0	5
6980536	of-course	https://github.com/unikent/of-course	1	0	0	1
6981791	qlcplus	https://github.com/speakman/qlcplus	3	0	0	3
6983246	ultisnips	https://github.com/MarcWeber/ultisnips	1	0	0	1
6986064	wp-advanced-search	https://github.com/growthspark/wp-advanced-search	1	2	0	3
6986104	suite-data	https://github.com/opengeo/suite-data	2	1	0	3
6988020	js-xlsx	https://github.com/Niggler/js-xlsx	1	0	0	1
6989152	latexbok	https://github.com/urdh/latexbok	0	1	0	1
7000422	commotion-bug-info	https://github.com/opentechinstitute/commotion-bug-info	1	0	0	1
7005463	PushPlugin	https://github.com/phonegap-build/PushPlugin	1	1	1	3
7006753	chromeextensions-knockoutjs	https://github.com/timstuyckens/chromeextensions-knockoutjs	1	1	0	2
7009393	towtruck	https://github.com/mozilla/towtruck	0	1	0	1
7016481	PayumBundle	https://github.com/Payum/PayumBundle	0	1	0	1
7017359	grunt-usemin	https://github.com/yeoman/grunt-usemin	0	1	0	1
7020321	Croquispop	https://github.com/crosspop/Croquispop	1	0	0	1
7026843	xhgui	https://github.com/preinheimer/xhgui	1	1	0	2
7040101	fairnopoly	https://github.com/fairnopoly/fairnopoly	2	0	0	2
7040983	stickyfloat	https://github.com/yairEO/stickyfloat	1	0	0	1
7047799	19wu	https://github.com/19wu/19wu	1	0	0	1
7055405	southwest-checkin	https://github.com/aortbals/southwest-checkin	0	3	0	3
7056202	format	https://github.com/vitaut/format	1	2	1	4
7058693	schemas	https://github.com/CybOXProject/schemas	2	0	0	2
7059000	cudr	https://github.com/christophemarois/cudr	0	1	0	1
7061640	tigerbrew	https://github.com/mistydemeo/tigerbrew	0	0	1	1
7066981	OPT_on_Skulpt	https://github.com/ankurankan/OPT_on_Skulpt	2	1	0	3
7068587	livehelperchat	https://github.com/remdex/livehelperchat	2	1	0	3
7072487	korok	https://github.com/kir-dev/korok	0	1	0	1
7074397	grunt-rev-md5	https://github.com/tactivos/grunt-rev-md5	1	0	0	1
7077837	dynroute	https://github.com/alessioalex/dynroute	3	4	0	7
7080576	crxprof	https://github.com/dkrotx/crxprof	1	0	0	1
7083240	orientdb	https://github.com/orientechnologies/orientdb	2	2	1	5
7083242	mysql	https://github.com/go-sql-driver/mysql	2	0	0	2
7095151	generator-ember	https://github.com/yeoman/generator-ember	1	0	0	1
7095300	quickblox-ios-sdk	https://github.com/QuickBlox/quickblox-ios-sdk	1	0	0	1
7102316	catbox	https://github.com/spumko/catbox	1	0	0	1
7107704	doc	https://github.com/coderhaoxin/doc	1	0	0	1
7121055	victims-web	https://github.com/victims/victims-web	4	1	0	5
7123799	varying-vagrant-vagrants	https://github.com/10up/varying-vagrant-vagrants	1	0	0	1
7125743	vafpress-framework	https://github.com/vafour/vafpress-framework	1	2	1	4
7131033	CK2Plus	https://github.com/CK2Plus/CK2Plus	1	1	0	2
7136348	slimerjs	https://github.com/laurentj/slimerjs	1	2	0	3
7137900	uonline	https://github.com/uonline/uonline	6	1	0	7
7139471	serenity-android	https://github.com/NineWorlds/serenity-android	2	1	0	3
7139620	skmath	https://github.com/urdh/skmath	1	0	0	1
7139726	skrapport	https://github.com/urdh/skrapport	0	1	0	1
7139992	antlr-ide	https://github.com/jknack/antlr-ide	1	0	0	1
7142302	http-streams	https://github.com/afcowie/http-streams	1	2	1	4
7143169	Clang.jl	https://github.com/ihnorton/Clang.jl	0	6	0	6
7152003	dap2arc	https://github.com/rsignell-usgs/dap2arc	1	0	0	1
7152142	q2pro	https://github.com/AndreyNazarov/q2pro	0	6	0	6
7158456	steroids-js	https://github.com/AppGyver/steroids-js	1	0	0	1
7159640	oclint	https://github.com/oclint/oclint	1	1	0	2
7166369	lmfdb	https://github.com/LMFDB/lmfdb	3	0	0	3
7170058	flyway	https://github.com/flyway/flyway	1	1	0	2
7171107	bucker	https://github.com/nlf/bucker	2	1	0	3
7172310	phetcommon	https://github.com/phetsims/phetcommon	1	0	0	1
7177096	Railcraft-IssueTracker	https://github.com/CovertJaguar/Railcraft-IssueTracker	1	1	0	2
7187411	STTweetLabel	https://github.com/SebastienThiebaud/STTweetLabel	1	0	0	1
7193433	ember-table	https://github.com/Addepar/ember-table	1	0	0	1
7193456	wagon	https://github.com/locomotivecms/wagon	1	0	0	1
7193465	php-fann	https://github.com/bukka/php-fann	0	1	0	1
7197487	gourmet	https://github.com/thinkle/gourmet	0	4	0	4
7197854	libPhoneNumber-iOS	https://github.com/me2day/libPhoneNumber-iOS	2	2	0	4
7201619	plugin.video.cinemassacre	https://github.com/Kr0nZ/plugin.video.cinemassacre	0	1	0	1
7204533	saltomic	https://github.com/sdruskat/saltomic	1	0	0	1
7207877	NSOrderedDictionary	https://github.com/Marxon13/NSOrderedDictionary	1	0	0	1
7209607	phpws	https://github.com/Devristo/phpws	1	0	0	1
7211210	chrome-apis-sublime	https://github.com/mangini/chrome-apis-sublime	1	0	0	1
7212383	chrome.dart	https://github.com/dart-gde/chrome.dart	0	1	0	1
7212432	MachineMusePowersuits	https://github.com/MachineMuse/MachineMusePowersuits	1	0	0	1
7213147	projects	https://github.com/Polymer/projects	1	1	0	2
7215173	rcpp-gallery	https://github.com/jjallaire/rcpp-gallery	0	1	0	1
7221513	artemis	https://github.com/stfc/artemis	8	0	0	8
7227299	trending-food	https://github.com/ICANS/trending-food	0	1	0	1
7228264	scss-lint	https://github.com/causes/scss-lint	2	0	0	2
7229063	crouton	https://github.com/dnschneid/crouton	1	0	0	1
7232352	SMF-Descriptive-Links	https://github.com/Spuds/SMF-Descriptive-Links	0	1	0	1
7235555	la4j	https://github.com/vkostyukov/la4j	3	2	0	5
7240364	lst	https://github.com/sitron/lst	1	0	0	1
7241039	BetterCMS	https://github.com/devbridge/BetterCMS	6	18	0	24
7242954	fluxcapacitor	https://github.com/majek/fluxcapacitor	1	1	0	2
7248956	steam-for-linux	https://github.com/ValveSoftware/steam-for-linux	1	0	0	1
7249881	Whisper	https://github.com/LegitTalon/Whisper	1	1	0	2
7251206	bulk-delete	https://github.com/sudar/bulk-delete	1	4	0	5
7252603	EcoGallery	https://github.com/falnatsheh/EcoGallery	1	0	0	1
7258790	isaac_aligner	https://github.com/sequencing/isaac_aligner	0	1	0	1
7261476	Pandora	https://github.com/Novator/Pandora	1	0	0	1
7262922	platform	https://github.com/MoltenMotherBoard/platform	0	1	0	1
7263824	zfr-rest	https://github.com/zf-fr/zfr-rest	0	1	0	1
7265984	stripe_to_xero	https://github.com/vidpresso/stripe_to_xero	0	1	0	1
7266208	Framer	https://github.com/koenbok/Framer	1	0	0	1
7268697	drywall	https://github.com/jedireza/drywall	1	0	0	1
7272128	arquillian-selenium-bom	https://github.com/arquillian/arquillian-selenium-bom	0	1	0	1
7278749	libcql	https://github.com/mstump/libcql	1	0	0	1
7280989	orgchart	https://github.com/unitedstates/orgchart	1	0	0	1
7281643	website-theme	https://github.com/KCSU/website-theme	1	0	0	1
7281786	scenery	https://github.com/phetsims/scenery	1	0	0	1
7285145	EpicRay	https://github.com/Squareys/EpicRay	1	1	0	2
7295686	random-weighted-choice	https://github.com/parmentf/random-weighted-choice	1	0	0	1
7305959	webclient	https://github.com/ddsc/webclient	1	0	0	1
7315112	redisq	https://github.com/runk/redisq	0	1	0	1
7320897	evolve	https://github.com/Xandaros/evolve	1	1	0	2
7325023	openGallery	https://github.com/blackfyre/openGallery	2	1	0	3
7326769	koala	https://github.com/oklai/koala	2	0	0	2
7328385	grunt-neuter	https://github.com/trek/grunt-neuter	1	0	0	1
7336335	escudo	https://github.com/esrille/escudo	2	1	0	3
7339176	sbvf2	https://github.com/swissbib/sbvf2	1	0	0	1
7352482	fluent-plugin-droonga	https://github.com/droonga/fluent-plugin-droonga	9	0	0	9
7362671	spring	https://github.com/jonleighton/spring	1	0	0	1
7363211	knex	https://github.com/tgriesser/knex	1	0	0	1
7369637	unity3d-store	https://github.com/soomla/unity3d-store	1	1	0	2
7370241	RIOT	https://github.com/RIOT-OS/RIOT	1	0	0	1
7372622	rex	https://github.com/mhulse/rex	1	0	0	1
7372729	mhulse.github.com	https://github.com/mhulse/mhulse.github.com	1	0	0	1
7374859	email-log	https://github.com/sudar/email-log	1	0	0	1
7374984	redmine_timesheet_plugin	https://github.com/arkhitech/redmine_timesheet_plugin	0	1	0	1
7377516	Shine	https://github.com/Person8880/Shine	3	2	0	5
7378757	antimicro	https://github.com/Ryochan7/antimicro	1	1	0	2
7379647	__issues	https://github.com/weepy/__issues	1	1	0	2
7380300	v-leaflet	https://github.com/mstahv/v-leaflet	2	0	0	2
7381656	notes	https://github.com/consindo/notes	1	0	0	1
7382964	AngularJS-Color-Picker	https://github.com/scottsword/AngularJS-Color-Picker	1	0	0	1
7386799	OctoPrint	https://github.com/foosel/OctoPrint	1	1	0	2
7387886	M13Checkbox	https://github.com/Marxon13/M13Checkbox	1	0	0	1
7395766	fuelphp	https://github.com/fuelphp/fuelphp	1	0	0	1
7399127	byu-acm	https://github.com/paulddraper/byu-acm	2	0	0	2
7399405	20121228	https://github.com/mahmoodramzani/20121228	0	4	0	4
7411615	PHP-Validation	https://github.com/Dachande663/PHP-Validation	1	1	0	2
7415520	course	https://github.com/NICTA/course	1	0	0	1
7415612	image-diet	https://github.com/samastur/image-diet	1	0	0	1
7424544	housemon	https://github.com/jcw/housemon	1	1	0	2
7424828	modxTalks	https://github.com/artdevue/modxTalks	2	0	0	2
7430030	pop-up-archive	https://github.com/PRX/pop-up-archive	1	0	0	1
7431261	roswiki	https://github.com/ros-infrastructure/roswiki	1	1	0	2
7444162	veris	https://github.com/vz-risk/veris	1	0	0	1
7444649	LibTech-Auditing-Cheatsheet	https://github.com/iSECPartners/LibTech-Auditing-Cheatsheet	1	0	0	1
7446792	WebPDA	https://github.com/xihui/WebPDA	1	0	0	1
7447534	Namcore-Studio	https://github.com/megasus/Namcore-Studio	0	2	0	2
7449864	source-maps	https://github.com/dart-lang/source-maps	2	3	0	5
7453589	OpenNI2-FreenectDriver	https://github.com/piedar/OpenNI2-FreenectDriver	1	0	0	1
7460143	ruuveal	https://github.com/kmdm/ruuveal	3	1	0	4
7469974	spring-data-build	https://github.com/spring-projects/spring-data-build	1	3	0	4
7474357	net-netconf	https://github.com/Juniper/net-netconf	0	1	0	1
7474564	typeplate.github.io	https://github.com/typeplate/typeplate.github.io	1	0	0	1
7479302	Flandrica	https://github.com/libis/Flandrica	0	1	0	1
7480345	robovm	https://github.com/robovm/robovm	1	1	0	2
7484248	commotion-apps	https://github.com/opentechinstitute/commotion-apps	5	0	0	5
7487301	opengovernment-app	https://github.com/opengovernment/opengovernment-app	6	10	0	16
7489006	express3-handlebars	https://github.com/ericf/express3-handlebars	1	1	0	2
7490782	loggins	https://github.com/gwu-libraries/loggins	2	1	0	3
7496319	isdhcplib	https://github.com/ialx/isdhcplib	1	0	0	1
7502247	Lealone	https://github.com/codefollower/Lealone	3	0	0	3
7503542	elife-bot	https://github.com/elifesciences/elife-bot	1	0	0	1
7504510	CitationsFromBarcodes	https://github.com/spurioso/CitationsFromBarcodes	4	1	0	5
7508411	RxJava	https://github.com/Netflix/RxJava	2	0	0	2
7508952	skatespots.co.uk	https://github.com/h2s/skatespots.co.uk	0	1	0	1
7512407	answers.ros.org	https://github.com/ros-infrastructure/answers.ros.org	1	5	0	6
7512484	ardupilot	https://github.com/diydrones/ardupilot	2	1	1	4
7513317	portfolio_website	https://github.com/Jacob-Friesen/portfolio_website	2	1	0	3
7514773	callisto-app	https://github.com/notbryant/callisto-app	1	0	0	1
7515495	wsh	https://github.com/worr/wsh	3	1	0	4
7521566	xamel	https://github.com/nodules/xamel	1	5	0	6
7525696	steel	https://github.com/starverte/steel	1	0	0	1
7525748	nekBedtools	https://github.com/nkindlon/nekBedtools	0	1	0	1
7527552	mailcore2	https://github.com/MailCore/mailcore2	5	6	0	11
7530570	appium	https://github.com/appium/appium	6	2	0	8
7532830	cite4wiking	https://github.com/abartov/cite4wiking	2	0	0	2
7535778	CircleLayout	https://github.com/dmitry-zaitsev/CircleLayout	0	1	0	1
7541258	SlopesAndCorners	https://github.com/SlimeVoid/SlopesAndCorners	2	0	0	2
7546002	PhlyRestfully	https://github.com/phly/PhlyRestfully	2	0	0	2
7546847	docs	https://github.com/laravel/docs	1	2	0	3
7548986	framework	https://github.com/laravel/framework	4	3	0	7
7550240	intlib	https://github.com/mff-uk/intlib	6	9	0	15
7551429	Hercules	https://github.com/HerculesWS/Hercules	2	0	0	2
7559760	Celero	https://github.com/DigitalInBlue/Celero	0	1	0	1
7566767	TemplateBinding	https://github.com/Polymer/TemplateBinding	1	6	0	7
7569578	discourse	https://github.com/discourse/discourse	1	0	0	1
7571859	cdogs-sdl	https://github.com/cxong/cdogs-sdl	1	2	0	3
7572490	wp-user-avatar	https://github.com/bangbay/wp-user-avatar	1	0	0	1
7573978	TeamCity.Node	https://github.com/jonnyzzz/TeamCity.Node	0	2	1	3
7575297	es	https://github.com/zhangkaitao/es	1	0	0	1
7575570	Terrae-Rasa	https://github.com/matthew-robertson/Terrae-Rasa	0	1	0	1
7577296	gplot	https://github.com/RhysU/gplot	1	0	0	1
7589144	euler	https://github.com/kalisjoshua/euler	9	2	0	11
7589802	ardent	https://github.com/laravelbook/ardent	1	0	0	1
7592322	script-bakery	https://github.com/CGCookie/script-bakery	6	0	0	6
7602457	yougi	https://github.com/htmfilho/yougi	1	1	0	2
7604731	monolith-aggregator	https://github.com/mozilla/monolith-aggregator	1	1	0	2
7605897	demo	https://github.com/hazirguo/demo	1	0	0	1
7607075	Probabilistic-Programming-and-Bayesian-Methods-for-Hackers	https://github.com/CamDavidsonPilon/Probabilistic-Programming-and-Bayesian-Methods-for-Hackers	0	1	0	1
7613509	mosql	https://github.com/stripe/mosql	1	0	0	1
7627452	MCPC-Plus-Legacy	https://github.com/MinecraftPortCentral/MCPC-Plus-Legacy	2	1	0	3
7628687	locawebstyle	https://github.com/locaweb/locawebstyle	0	3	0	3
7628888	6502	https://github.com/rpedde/6502	4	0	0	4
7630011	ClearCanvas	https://github.com/ClearCanvas/ClearCanvas	1	0	0	1
7630574	geometry-api-java	https://github.com/Esri/geometry-api-java	0	1	0	1
7633192	byu-animation-tools	https://github.com/byu-animation/byu-animation-tools	0	3	0	3
7634215	vilify	https://github.com/HTML5-Games/vilify	1	0	0	1
7639232	protractor	https://github.com/angular/protractor	1	1	0	2
7640739	knockout-jqueryui	https://github.com/gvas/knockout-jqueryui	0	1	0	1
7641372	isis-wicket-gmap3	https://github.com/danhaywood/isis-wicket-gmap3	1	0	0	1
7649907	eap-build	https://github.com/hasalex/eap-build	1	0	0	1
7653178	sufia	https://github.com/projecthydra/sufia	2	1	0	3
7665906	RegESM	https://github.com/uturuncoglu/RegESM	2	0	0	2
7667591	python	https://github.com/agnwinds/python	1	2	0	3
7675929	sddm	https://github.com/sddm/sddm	0	1	0	1
7676364	phoenix	https://github.com/forcedotcom/phoenix	3	1	1	5
7676934	kiva-country-collector	https://github.com/bswopes/kiva-country-collector	1	0	0	1
7678347	zTree_v3	https://github.com/zTree/zTree_v3	1	0	0	1
7678597	project_overview	https://github.com/mbasset/project_overview	1	0	0	1
7683174	footballSpread	https://github.com/FenrirUnbound/footballSpread	1	0	0	1
7691631	docker	https://github.com/dotcloud/docker	7	3	0	10
7693799	ui-router	https://github.com/angular-ui/ui-router	3	20	0	23
7693836	butterflies	https://github.com/curtisullerich/butterflies	3	1	0	4
7694290	netlib-java	https://github.com/fommil/netlib-java	0	2	0	2
7695610	matte	https://github.com/montagejs/matte	1	0	0	1
7695692	cinnamon-pomodoro	https://github.com/gfreeau/cinnamon-pomodoro	0	1	0	1
7695912	SpiderOakMobileClient	https://github.com/SpiderOak/SpiderOakMobileClient	1	0	0	1
7697473	microstrain_3dmgx2_imu	https://github.com/ros-drivers/microstrain_3dmgx2_imu	1	0	0	1
7709656	datagrepper	https://github.com/fedora-infra/datagrepper	0	1	0	1
7710120	sculptor	https://github.com/sculptor/sculptor	0	2	1	3
7712379	opps	https://github.com/opps/opps	1	0	0	1
7719855	arkos	https://github.com/cznweb/arkos	2	0	0	2
7721204	Responsive_Template	https://github.com/kthornbloom/Responsive_Template	1	0	0	1
7721234	openmuni-budgets	https://github.com/hasadna/openmuni-budgets	1	1	0	2
7723866	rbnacl	https://github.com/cryptosphere/rbnacl	1	0	0	1
7724771	phi	https://github.com/joichiro/phi	15	1	0	16
7729021	prevarisc	https://github.com/SDIS62/prevarisc	0	2	0	2
7731536	ga_events	https://github.com/Nix-wie-weg/ga_events	0	1	0	1
7738366	tv4	https://github.com/geraintluff/tv4	0	1	0	1
7741856	pixi.js	https://github.com/GoodBoyDigital/pixi.js	2	0	0	2
7742825	idno	https://github.com/idno/idno	2	1	0	3
7744490	BlobGame	https://github.com/watterso/BlobGame	0	11	0	11
7745225	kpm	https://github.com/kissygalleryteam/kpm	1	0	0	1
7749120	path-iterator-rule	https://github.com/dagolden/path-iterator-rule	2	0	0	2
7752664	ion.rangeSlider	https://github.com/IonDen/ion.rangeSlider	1	0	0	1
7754585	WooCommerce-Invoice-Payment-Gateway	https://github.com/davidpaulsson/WooCommerce-Invoice-Payment-Gateway	0	1	0	1
7756670	extjsmvcolors	https://github.com/snowflakeproductionsgmbh/extjsmvcolors	1	0	0	1
7756876	MuPDF.WinRT	https://github.com/MishaUliutin/MuPDF.WinRT	1	0	0	1
7759663	nctoolbox	https://github.com/nctoolbox/nctoolbox	0	1	0	1
7760890	TinkersConstruct	https://github.com/mDiyo/TinkersConstruct	3	2	0	5
7762720	medsavant	https://github.com/compbio-UofT/medsavant	0	7	0	7
7763363	ratpack	https://github.com/ratpack/ratpack	1	0	0	1
7763423	stripe	https://github.com/lewiswharf/stripe	1	0	0	1
7770052	ChronoZoom	https://github.com/alterm4nn/ChronoZoom	0	3	1	4
7775363	comment_tracker	https://github.com/Scarygami/comment_tracker	0	2	0	2
7782629	web-app-starter-kit	https://github.com/cferdinandi/web-app-starter-kit	1	0	0	1
7784091	LogisticsPipes-Dev	https://github.com/RS485/LogisticsPipes-Dev	2	2	0	4
7793129	izhihu	https://github.com/unogz/izhihu	2	2	0	4
7794838	typo3-bib	https://github.com/subugoe/typo3-bib	4	0	0	4
7805574	bootstrap-switch	https://github.com/nostalgiaz/bootstrap-switch	0	1	0	1
7807286	gale	https://github.com/grawity/gale	1	0	0	1
7807399	processing	https://github.com/processing/processing	0	0	1	1
7812229	tapiriik	https://github.com/cpfair/tapiriik	1	0	0	1
7812624	smooth-scroll	https://github.com/cferdinandi/smooth-scroll	2	1	0	3
7828104	chocolatey-packages	https://github.com/Laures/chocolatey-packages	1	0	0	1
7828634	AndroidCircularSeekBar	https://github.com/RaghavSood/AndroidCircularSeekBar	1	0	0	1
7832859	android-app	https://github.com/eoecn/android-app	0	1	0	1
7833168	kibana	https://github.com/elasticsearch/kibana	2	0	0	2
7834032	negroku	https://github.com/platanus/negroku	1	0	0	1
7834706	fcontrol	https://github.com/mamont77/fcontrol	0	1	0	1
7836045	ODBC.jl	https://github.com/karbarcca/ODBC.jl	1	1	0	2
7836995	ChinaUnicom-NetSpeed-Client	https://github.com/biergaizi/ChinaUnicom-NetSpeed-Client	1	0	0	1
7837589	TreeTable	https://github.com/Sciss/TreeTable	2	0	0	2
7838352	campus-swing	https://github.com/anoane/campus-swing	0	19	0	19
7843586	ccd-geo	https://github.com/hhba/ccd-geo	1	0	0	1
7845874	buildblast	https://github.com/crazy2be/buildblast	1	0	0	1
7849716	forceworkbench	https://github.com/ryanbrainard/forceworkbench	1	0	0	1
7849940	AndroidCaldavSyncAdapater	https://github.com/gggard/AndroidCaldavSyncAdapater	2	1	0	3
7856020	rspec-puppet-augeas	https://github.com/domcleal/rspec-puppet-augeas	1	0	0	1
7856349	pda	https://github.com/keenhenry/pda	3	0	0	3
7859915	CHAdvanced	https://github.com/LadyCailin/CHAdvanced	2	0	0	2
7860109	secureheader	https://github.com/kr/secureheader	2	0	0	2
7860343	TweetPony	https://github.com/Mezgrman/TweetPony	0	1	0	1
7869881	visionion	https://github.com/tomlurge/visionion	1	0	0	1
7871198	quantcomponents	https://github.com/lsgro/quantcomponents	1	2	0	3
7874074	howler.js	https://github.com/goldfire/howler.js	1	0	0	1
7878034	silverstripe-display-logic	https://github.com/unclecheese/silverstripe-display-logic	0	1	0	1
7882287	Language	https://github.com/OVALProject/Language	0	4	0	4
7883897	git-remote-gcrypt	https://github.com/blake2-ppc/git-remote-gcrypt	1	0	0	1
7885162	tetris	https://github.com/pfraces/tetris	1	0	0	1
7887589	open-orgn-services	https://github.com/theodi/open-orgn-services	1	1	0	2
7889772	django-mptt-admin	https://github.com/leukeleu/django-mptt-admin	1	0	0	1
7891899	dafcollage	https://github.com/seiya64/dafcollage	1	0	0	1
7892751	scrz	https://github.com/scrz/scrz	1	0	0	1
7893268	DomniklStatsdBundle	https://github.com/domnikl/DomniklStatsdBundle	1	0	0	1
7896460	LinkedGeoData	https://github.com/GeoKnow/LinkedGeoData	2	0	0	2
7899791	Vintageous	https://github.com/guillermooo/Vintageous	1	0	0	1
7899891	DMS	https://github.com/pagelines/DMS	2	3	0	5
7901658	rbenv-default-gems	https://github.com/sstephenson/rbenv-default-gems	1	0	0	1
7909420	elasticsearch-segmentspy	https://github.com/polyfractal/elasticsearch-segmentspy	1	0	0	1
7913469	ServiceControl	https://github.com/Particular/ServiceControl	1	0	0	1
7913815	bluLime-CMS	https://github.com/PITS/bluLime-CMS	1	1	0	2
7915243	XDE-Resources	https://github.com/XDE-ISIR/XDE-Resources	2	0	0	2
7919054	fatiando	https://github.com/leouieda/fatiando	0	2	0	2
7921712	minion-zap-plugin	https://github.com/mozilla/minion-zap-plugin	0	2	0	2
7924335	AndroidGeo	https://github.com/appcelerator-training/AndroidGeo	1	0	0	1
7925925	memsim	https://github.com/joewing/memsim	1	0	0	1
7930418	geoweb	https://github.com/OpenGeoscience/geoweb	0	3	0	3
7934816	javascript-libraries-syntax.vim	https://github.com/othree/javascript-libraries-syntax.vim	1	2	1	4
7936262	MongoYii	https://github.com/Sammaye/MongoYii	2	2	0	4
7939152	project-list	https://github.com/vculibraries/project-list	2	1	0	3
7942186	moedict-webkit	https://github.com/audreyt/moedict-webkit	0	1	0	1
7942805	tuf	https://github.com/theupdateframework/tuf	0	3	0	3
7945384	tecla-framework	https://github.com/idrc/tecla-framework	1	0	0	1
7950442	gooeyOS	https://github.com/notanimposter/gooeyOS	0	1	0	1
7959652	abrt	https://github.com/abrt/abrt	1	1	0	2
7961284	gnome-abrt	https://github.com/abrt/gnome-abrt	3	0	0	3
7964976	humans	https://github.com/gittip/humans	1	0	0	1
7966776	fswms	https://github.com/nemac/fswms	0	1	1	2
7970632	school	https://github.com/kolinkrewinkel/school	0	1	0	1
7978277	sfArkLib	https://github.com/raboof/sfArkLib	1	0	0	1
7979916	life	https://github.com/paranoida/life	1	0	0	1
7980437	ember-rails-devise-demo	https://github.com/kagemusha/ember-rails-devise-demo	1	1	0	2
7981028	reporte-ciudadano	https://github.com/CodeandoMexico/reporte-ciudadano	3	1	0	4
7988633	wbench	https://github.com/desktoppr/wbench	0	1	0	1
7990775	Quark	https://github.com/maddisondesigns/Quark	1	0	0	1
7991741	checkmyidp.org	https://github.com/shane-tomlinson/checkmyidp.org	1	0	0	1
7993297	ffs	https://github.com/djs55/ffs	1	0	0	1
7997016	Bootstrap-Admin-Theme	https://github.com/VinceG/Bootstrap-Admin-Theme	1	0	0	1
8000907	haroopad	https://github.com/rhiokim/haroopad	1	1	0	2
8001025	redis	https://github.com/gosexy/redis	1	1	0	2
8004546	darm	https://github.com/jbremer/darm	0	1	0	1
8008015	buddycloud-android	https://github.com/buddycloud/buddycloud-android	0	1	0	1
8011111	RobotFoot	https://github.com/mtiudaeu/RobotFoot	0	1	0	1
8014135	py-lmdb	https://github.com/dw/py-lmdb	0	1	0	1
8018179	MissionPlanner	https://github.com/diydrones/MissionPlanner	1	3	0	4
8020995	km-support	https://github.com/kissmetrics/km-support	1	0	0	1
8025185	ios-driver	https://github.com/ios-driver/ios-driver	1	0	0	1
8025232	LuaSkillsForQSGS	https://github.com/DGAH/LuaSkillsForQSGS	0	1	0	1
8027020	archer	https://github.com/IcecaveStudios/archer	1	0	0	1
8031788	stele	https://github.com/makingdevs/stele	0	3	0	3
8032839	mp	https://github.com/DPMI/mp	1	0	0	1
8037233	remoteValidation	https://github.com/bighostkim/remoteValidation	2	0	0	2
8041621	StreamHub-Android-SDK	https://github.com/Livefyre/StreamHub-Android-SDK	1	0	0	1
8042884	wtframework	https://github.com/wiredrive/wtframework	0	1	0	1
8043756	stan	https://github.com/stan-dev/stan	1	0	0	1
8046269	libwebsockets	https://github.com/warmcat/libwebsockets	1	0	0	1
8048400	merlin	https://github.com/def-lkb/merlin	1	1	0	2
8054475	upsilon	https://github.com/jamesread/upsilon	5	4	0	9
8056641	SolSeedCreed	https://github.com/SolSeed/SolSeedCreed	0	0	1	1
8059275	csswizardry-grids	https://github.com/csswizardry/csswizardry-grids	1	0	0	1
8060522	crowdfunding	https://github.com/Astoundify/crowdfunding	1	0	0	1
8064928	VIC	https://github.com/UW-Hydro/VIC	1	0	0	1
8065417	spec	https://github.com/remotestorage/spec	4	0	0	4
8066487	torbrowser-launcher	https://github.com/micahflee/torbrowser-launcher	0	1	0	1
8066758	dropplets	https://github.com/circa75/dropplets	3	2	0	5
8067784	microformats2	https://github.com/G5/microformats2	1	0	0	1
8067805	entrust	https://github.com/Zizaco/entrust	0	1	0	1
8069502	DidIPassHSR	https://github.com/mweibel/DidIPassHSR	1	1	0	2
8069971	roole	https://github.com/curvedmark/roole	1	0	0	1
8071994	argilla	https://github.com/shogodev/argilla	1	3	0	4
8075291	ziften	https://github.com/mac-cain13/ziften	1	0	0	1
8075584	cag_tools	https://github.com/libis/cag_tools	1	2	0	3
8077402	MISP	https://github.com/MISP/MISP	1	1	0	2
8080963	hamster	https://github.com/gsobczyk/hamster	1	1	0	2
8082049	universal-analytics	https://github.com/peaksandpies/universal-analytics	0	1	0	1
8084912	ohms-law	https://github.com/phetsims/ohms-law	0	1	1	2
8097660	WizarDroid	https://github.com/Nimrodda/WizarDroid	2	3	0	5
8099417	elasticsearch-newrelic	https://github.com/viniciusccarvalho/elasticsearch-newrelic	1	0	0	1
8105188	Flexbox.less	https://github.com/ProLoser/Flexbox.less	0	1	0	1
8105769	gradecraft-development	https://github.com/bellotastudios/gradecraft-development	1	9	0	10
8105962	states	https://github.com/auser/states	1	0	0	1
8108108	xunlei-lixian-web	https://github.com/raptorz/xunlei-lixian-web	0	1	0	1
8109693	gettingstartedwithchef	https://github.com/hellofuture/gettingstartedwithchef	0	1	0	1
8114616	WebQuake	https://github.com/SiPlus/WebQuake	0	0	1	1
8116551	contracard	https://github.com/SamWhited/contracard	4	1	0	5
8116551	contra-card	https://github.com/SamWhited/contra-card	4	1	0	5
8118847	parallel.js	https://github.com/adambom/parallel.js	1	1	0	2
8136088	ngriakadmin	https://github.com/mwl/ngriakadmin	1	2	0	3
8137276	puppet-r1soft-cdp-agent	https://github.com/lboynton/puppet-r1soft-cdp-agent	0	1	0	1
8137449	perfload	https://github.com/mgm-tp/perfload	1	1	0	2
8138557	barbican	https://github.com/cloudkeep/barbican	0	1	0	1
8141240	testflight-module	https://github.com/dasmurphy/testflight-module	0	1	0	1
8147861	lazy-alloy	https://github.com/vastness/lazy-alloy	0	1	0	1
8148516	theseus	https://github.com/adobe-research/theseus	1	1	0	2
8149048	arcgis-samples-flex	https://github.com/Esri/arcgis-samples-flex	1	0	0	1
8152808	twitter-flight-rails	https://github.com/yourabi/twitter-flight-rails	1	0	0	1
8159960	issues	https://github.com/dandelion/issues	1	1	0	2
8162718	libdl-sh	https://github.com/donkarlos/libdl-sh	4	0	0	4
8166324	flyway-sbt-plugin	https://github.com/sean8223/flyway-sbt-plugin	0	1	0	1
8170346	sidr	https://github.com/artberri/sidr	1	1	0	2
8170958	browser-plugin	https://github.com/shotgunsoftware/browser-plugin	0	1	1	2
8171472	solidus	https://github.com/SparkartGroupInc/solidus	1	0	0	1
8176621	chef-repo	https://github.com/indykish/chef-repo	1	0	0	1
8177857	Android-Wheel-Menu	https://github.com/anupcowkur/Android-Wheel-Menu	0	1	0	1
8178062	database-epileptic-patients	https://github.com/Dworzaaa/database-epileptic-patients	15	9	0	24
8178639	ZendOptimizerPlus	https://github.com/zendtech/ZendOptimizerPlus	0	1	0	1
8179702	dynare	https://github.com/DynareTeam/dynare	1	0	0	1
8180179	commotiond	https://github.com/opentechinstitute/commotiond	1	0	0	1
8181455	squid	https://github.com/opscode-cookbooks/squid	1	0	0	1
8187294	akka-concurrency-wyatt	https://github.com/danluu/akka-concurrency-wyatt	1	0	0	1
8189762	chronos	https://github.com/airbnb/chronos	1	0	0	1
8191342	Battle-Chat	https://github.com/ninetwozero/Battle-Chat	0	1	0	1
8197787	YACassandraPDO	https://github.com/Orange-OpenSource/YACassandraPDO	0	1	0	1
8200000	Vegdata	https://github.com/lsmeby/Vegdata	1	0	0	1
8201198	TiExtendView	https://github.com/k0sukey/TiExtendView	0	1	0	1
8201494	jumbodb	https://github.com/comsysto/jumbodb	0	1	0	1
8202383	device-component-ng	https://github.com/lelylan/device-component-ng	2	0	0	2
8207159	halflife	https://github.com/ValveSoftware/halflife	2	7	0	9
8209759	docs	https://github.com/dotcloud/docs	1	0	0	1
8209930	gif-movie-view	https://github.com/sbakhtiarov/gif-movie-view	1	0	0	1
8210419	resistance-in-a-wire	https://github.com/phetsims/resistance-in-a-wire	0	1	0	1
8211227	php-calendar	https://github.com/sproctor/php-calendar	1	0	0	1
8216154	TweetLanes	https://github.com/chrislacy/TweetLanes	2	1	0	3
8220233	fixflow	https://github.com/fixteam/fixflow	20	8	1	29
8223542	Source-1-Games	https://github.com/ValveSoftware/Source-1-Games	3	0	1	4
8223716	bernard	https://github.com/bernardphp/bernard	0	2	0	2
8225987	sanger	https://github.com/JonathanReeve/sanger	2	2	0	4
8227886	nmrihissues	https://github.com/ZPSNMRiHIssues/nmrihissues	1	0	0	1
8231466	MediaBrowser	https://github.com/MediaBrowser/MediaBrowser	1	0	0	1
8233105	fontbakery	https://github.com/xen/fontbakery	1	2	0	3
8235917	TwitterBootstrapBundle	https://github.com/andrey1s/TwitterBootstrapBundle	1	0	0	1
8236056	mini2Dx	https://github.com/tomcashman/mini2Dx	1	0	0	1
8238359	contrack	https://github.com/samirmenon/contrack	1	0	0	1
8241538	ingress-intel-total-conversion	https://github.com/jonatkins/ingress-intel-total-conversion	0	1	0	1
8241543	jellyrisk	https://github.com/ygneo/jellyrisk	1	0	0	1
8243254	Superuser	https://github.com/koush/Superuser	1	0	0	1
8246455	minq	https://github.com/jden/minq	1	0	0	1
8251485	qLib	https://github.com/qLab/qLib	2	0	0	2
8257106	MessagesTableViewController	https://github.com/jessesquires/MessagesTableViewController	1	0	0	1
8257528	TiddlyWikiPlugins	https://github.com/tobibeer/TiddlyWikiPlugins	1	0	0	1
8257708	nova3	https://github.com/anodyne/nova3	1	0	0	1
8259466	setup	https://github.com/loopinfinito/setup	1	0	0	1
8263712	ghc	https://github.com/jstolarek/ghc	8	3	0	11
8266573	SlipStreamServer	https://github.com/slipstream/SlipStreamServer	4	0	0	4
8270972	mbed	https://github.com/mbedmicro/mbed	0	1	0	1
8271291	rultor	https://github.com/rultor/rultor	5	2	0	7
8273037	Depression_Prevention_Program	https://github.com/SamPortnow/Depression_Prevention_Program	1	0	0	1
8274745	conductor.js	https://github.com/tildeio/conductor.js	0	1	0	1
8275010	L4withSentry	https://github.com/rydurham/L4withSentry	0	1	0	1
8276270	Traktable	https://github.com/yo-han/Traktable	0	1	1	2
8280198	c2ffi	https://github.com/rpav/c2ffi	0	1	0	1
8283085	bladeRF	https://github.com/Nuand/bladeRF	4	1	0	5
8284977	LimeSoda_SampleDataGenerator	https://github.com/LimeSoda/LimeSoda_SampleDataGenerator	2	0	0	2
8285747	Laravel-4-Generators	https://github.com/JeffreyWay/Laravel-4-Generators	1	0	0	1
8287740	pyjavaseis	https://github.com/asbjorn/pyjavaseis	1	0	0	1
8289042	SlipStreamDocumentation	https://github.com/slipstream/SlipStreamDocumentation	9	1	0	10
8292625	OTM2	https://github.com/azavea/OTM2	5	11	0	16
8295380	pysal	https://github.com/pysal/pysal	2	0	0	2
8297021	dleyna-renderer	https://github.com/01org/dleyna-renderer	1	0	0	1
8297311	Crypto	https://github.com/VRyazanov/Crypto	0	1	0	1
8297644	jeo	https://github.com/cardume/jeo	1	2	0	3
8297888	typeahead.js	https://github.com/twitter/typeahead.js	2	0	0	2
8298987	podlove-web-player	https://github.com/podlove/podlove-web-player	0	1	0	1
8301168	PayPal-iOS-SDK	https://github.com/paypal/PayPal-iOS-SDK	0	1	0	1
8309171	jsonRPC.js	https://github.com/Mtnt/jsonRPC.js	1	1	0	2
8309253	picotcp	https://github.com/tass-belgium/picotcp	1	0	0	1
8311444	Barzahlen-Java	https://github.com/Barzahlen/Barzahlen-Java	1	0	0	1
8319043	forces-and-motion-basics	https://github.com/phetsims/forces-and-motion-basics	1	1	1	3
8320144	topCalc	https://github.com/sitegui/topCalc	2	0	0	2
8323759	Tweet.js-Mod	https://github.com/StanScates/Tweet.js-Mod	0	1	0	1
8323977	RPIO	https://github.com/metachris/RPIO	1	0	0	1
8328769	HammerTime	https://github.com/anas-ambri/HammerTime	6	1	0	7
8331069	member-directory	https://github.com/theodi/member-directory	1	0	0	1
8332752	addons.silverstripe.org	https://github.com/silverstripe/addons.silverstripe.org	2	3	0	5
8335020	BrightstarDB	https://github.com/BrightstarDB/BrightstarDB	0	1	0	1
8338901	DBdownload	https://github.com/ldx/DBdownload	1	1	0	2
8339278	sassquatch	https://github.com/meetup/sassquatch	2	0	0	2
8344033	django-nested-inlines	https://github.com/Soaa-/django-nested-inlines	1	0	0	1
8344868	woocommerce-boleto	https://github.com/wpbrasil/woocommerce-boleto	1	1	0	2
8346495	commonjs-everywhere	https://github.com/michaelficarra/commonjs-everywhere	0	1	0	1
8347276	zfs	https://github.com/zfs-osx/zfs	0	1	0	1
8348565	dot	https://github.com/phetsims/dot	1	0	0	1
8353416	anime-db	https://github.com/anime-db/anime-db	3	2	0	5
8363625	clang-tags	https://github.com/ffevotte/clang-tags	1	0	0	1
8365472	dx11-vvvv	https://github.com/mrvux/dx11-vvvv	1	0	0	1
8365976	slash	https://github.com/vmalloc/slash	1	2	0	3
8367392	PyPump	https://github.com/xray7224/PyPump	2	0	0	2
8394039	t3_less	https://github.com/greinerd/t3_less	1	0	0	1
8394454	codeigniter-modular-extensions-hmvc	https://github.com/Bigwebmaster/codeigniter-modular-extensions-hmvc	0	1	0	1
8399868	local_manifests	https://github.com/LegacyXperia/local_manifests	2	0	0	2
8400509	support	https://github.com/orchestral/support	1	1	0	2
8410558	scrm	https://github.com/paulstaab/scrm	0	1	0	1
8410902	apostrophe-sandbox	https://github.com/punkave/apostrophe-sandbox	2	1	0	3
8417201	shake	https://github.com/ndmitchell/shake	1	1	0	2
8417775	selection-js	https://github.com/czproject/selection-js	3	0	0	3
8418273	ruby	https://github.com/pubnub/ruby	1	1	0	2
8419607	ShadowDOM	https://github.com/Polymer/ShadowDOM	4	5	1	10
8419933	ui-utils	https://github.com/angular-ui/ui-utils	1	1	0	2
8424756	chef_logstash	https://github.com/miah/chef_logstash	0	2	0	2
8430423	MOOC-material	https://github.com/UniversityHelsinkiTKTL/MOOC-material	0	1	0	1
8436977	Numix	https://github.com/shimmerproject/Numix	1	1	0	2
8448090	financial_fundamentals	https://github.com/andrewkittredge/financial_fundamentals	1	0	0	1
8458155	open-data-certificate	https://github.com/theodi/open-data-certificate	1	0	0	1
8463065	node-ftps	https://github.com/Atinux/node-ftps	0	1	0	1
8465253	pigsty	https://github.com/threatstack/pigsty	1	1	0	2
8467561	DevCPU	https://github.com/HerobrinesArmy/DevCPU	1	0	0	1
8467667	AjaxLoginBundle	https://github.com/Divi/AjaxLoginBundle	0	2	0	2
8468021	bash_prompt	https://github.com/ch3pjw/bash_prompt	1	0	0	1
8470606	assemble-less	https://github.com/assemble/assemble-less	1	1	0	2
8471494	CampusKit	https://github.com/Trott/CampusKit	2	0	0	2
8471572	foundation	https://github.com/orchestral/foundation	1	0	0	1
8473804	KGStatusBar	https://github.com/kevingibbon/KGStatusBar	1	0	0	1
8475609	incubator-drill	https://github.com/XingCloud/incubator-drill	0	7	0	7
8477375	Seasoning	https://github.com/Gargamel1989/Seasoning	19	0	0	19
8483854	zed	https://github.com/zedapp/zed	3	2	0	5
8483870	corund	https://github.com/impworks/corund	0	1	0	1
8484463	karma-teamcity-reporter	https://github.com/karma-runner/karma-teamcity-reporter	1	0	0	1
8484623	clean-image-crop-uploader	https://github.com/asaglimbeni/clean-image-crop-uploader	1	0	0	1
8484801	Brackets-Themes	https://github.com/MiguelCastillo/Brackets-Themes	0	1	0	1
8486799	sails-mongo	https://github.com/balderdashy/sails-mongo	1	1	0	2
8486991	simple-api	https://github.com/josephwegner/simple-api	1	0	0	1
8488148	Project-Risen	https://github.com/le717/Project-Risen	0	1	0	1
8488462	mc-coal	https://github.com/gumptionthomas/mc-coal	1	0	0	1
8489632	sdsl-lite	https://github.com/simongog/sdsl-lite	1	1	0	2
8490636	RETableViewManager	https://github.com/romaonthego/RETableViewManager	2	5	0	7
8490984	objective-c	https://github.com/pubnub/objective-c	0	1	0	1
8494441	maproulette	https://github.com/osmlab/maproulette	1	0	0	1
8497523	install-sot	https://github.com/stack-of-tasks/install-sot	1	0	0	1
8500809	samba4-gaps	https://github.com/baboons/samba4-gaps	1	0	0	1
8507500	bootstrap-cf-plugin	https://github.com/cloudfoundry/bootstrap-cf-plugin	1	0	0	1
8517246	lixian-portal	https://github.com/layerssss/lixian-portal	4	0	0	4
8525214	hoodie.admin.js	https://github.com/hoodiehq/hoodie.admin.js	1	0	0	1
8533735	OpenRAWeb	https://github.com/OpenRA/OpenRAWeb	2	0	0	2
8541340	DocLister	https://github.com/AgelxNash/DocLister	4	5	0	9
8542257	Units	https://github.com/MakeBetter/Units	1	0	0	1
8543947	vagrant-rackspace	https://github.com/mitchellh/vagrant-rackspace	1	0	0	1
8545220	bootstrap-expo	https://github.com/twbs/bootstrap-expo	0	1	0	1
8557873	Gumby	https://github.com/GumbyFramework/Gumby	1	0	0	1
8559748	testtwf-website	https://github.com/w3c/testtwf-website	1	6	0	7
8560576	pedestal	https://github.com/pedestal/pedestal	1	0	0	1
8566548	powerbot	https://github.com/powerbot/powerbot	1	3	0	4
8574371	roadrunner	https://github.com/skiptag/roadrunner	2	0	0	2
8574898	annotated_redis_source	https://github.com/huangz1990/annotated_redis_source	1	1	0	2
8585955	IJulia.jl	https://github.com/JuliaLang/IJulia.jl	1	2	1	4
8595651	AngularJS-sublime-package	https://github.com/angular-ui/AngularJS-sublime-package	0	1	0	1
8608767	php-sdk	https://github.com/constantcontact/php-sdk	1	0	0	1
8634516	Skivvy	https://github.com/atelierabbey/Skivvy	2	1	0	3
8634788	lab	https://github.com/spumko/lab	0	1	0	1
8635901	tern	https://github.com/marijnh/tern	3	0	0	3
8636223	HCapture	https://github.com/YakindanEgitim/HCapture	1	0	0	1
8641067	Caldroid	https://github.com/roomorama/Caldroid	1	0	0	1
8641543	zju-jwb-to-icalendar	https://github.com/xhacker/zju-jwb-to-icalendar	0	1	0	1
8649830	rest-api-sdk-python	https://github.com/paypal/rest-api-sdk-python	1	0	0	1
8653545	twitter-api-php	https://github.com/J7mbo/twitter-api-php	1	1	0	2
8654695	curate_nd	https://github.com/ndlib/curate_nd	0	1	0	1
8657056	RSiteCatalyst	https://github.com/randyzwitch/RSiteCatalyst	0	1	0	1
8659614	grunt-php	https://github.com/sindresorhus/grunt-php	1	0	0	1
8666557	routrrr	https://github.com/Cheeseen/routrrr	0	1	0	1
8670213	modman-php	https://github.com/sitewards/modman-php	1	0	0	1
8677095	legacy-jclouds-labs	https://github.com/jclouds/legacy-jclouds-labs	0	1	0	1
8680846	editor	https://github.com/lepture/editor	1	0	0	1
8686114	MostWebGen	https://github.com/Guite/MostWebGen	0	1	0	1
8686855	intro.js	https://github.com/usablica/intro.js	1	1	0	2
8693502	amazonica	https://github.com/mcohen01/amazonica	1	0	0	1
8693657	RFPixelControl	https://github.com/komby/RFPixelControl	1	0	0	1
8699761	Blog	https://github.com/JingxuanWang/Blog	1	0	0	1
8700190	BESDIRAC	https://github.com/mirguest/BESDIRAC	1	0	0	1
8706636	puid	https://github.com/pid/puid	1	1	0	2
8707973	ooni-backend	https://github.com/TheTorProject/ooni-backend	1	0	0	1
8715969	ancbrigade	https://github.com/codefordc/ancbrigade	0	1	0	1
8716335	MediaBrowser.Administration	https://github.com/MediaBrowser/MediaBrowser.Administration	0	1	0	1
8720143	scenery-phet	https://github.com/phetsims/scenery-phet	1	0	0	1
8729689	mongo	https://github.com/Tokutek/mongo	3	1	0	4
8741859	jsplain	https://github.com/dacamp/jsplain	0	1	0	1
8745474	active-markdown	https://github.com/alecperkins/active-markdown	1	0	0	1
8745739	S4201715125V1	https://github.com/4201715125/S4201715125V1	1	1	0	2
8751770	bootstrap-calendar	https://github.com/Serhioromano/bootstrap-calendar	2	1	0	3
8753562	gravity-forms-quantity-limits	https://github.com/bhays/gravity-forms-quantity-limits	1	0	0	1
8762092	atmosphere-play	https://github.com/Atmosphere/atmosphere-play	1	0	0	1
8768406	autoprefixer	https://github.com/ai/autoprefixer	1	1	0	2
8769501	openerp-zimbra-connector	https://github.com/vnc-biz/openerp-zimbra-connector	0	1	0	1
8770296	peerlibrary	https://github.com/peerlibrary/peerlibrary	2	0	0	2
8774208	gallery-css	https://github.com/benschwarz/gallery-css	0	1	0	1
8775214	message_library	https://github.com/humanitarianresponse/message_library	2	2	0	4
8775267	mailreader	https://github.com/stuporglue/mailreader	1	0	0	1
8776306	cookbook.bind	https://github.com/TAMUArch/cookbook.bind	1	0	0	1
8776654	CallAdmin	https://github.com/Impact123/CallAdmin	0	2	0	2
8777786	ansible-playbooks	https://github.com/gc3-uzh-ch/ansible-playbooks	1	0	0	1
8779606	assertj-core	https://github.com/joel-costigliola/assertj-core	1	0	0	1
8781335	jquery.panzoom	https://github.com/timmywil/jquery.panzoom	2	2	0	4
8786261	reallocate	https://github.com/reallocate/reallocate	1	0	0	1
8796235	Leed	https://github.com/ldleman/Leed	1	0	0	1
8797228	messaging	https://github.com/sysapps/messaging	0	1	0	1
8797523	Rock-Hammer	https://github.com/malarkey/Rock-Hammer	0	1	0	1
8806972	browserify-middleware	https://github.com/ForbesLindesay/browserify-middleware	1	1	0	2
8807030	coapp.powershell	https://github.com/coapp/coapp.powershell	3	0	0	3
8811187	ChargePadsEx	https://github.com/Myrathi/ChargePadsEx	1	0	0	1
8814504	snorkel	https://github.com/okayzed/snorkel	2	0	0	2
8815876	Snap--Build-Your-Own-Blocks	https://github.com/jmoenig/Snap--Build-Your-Own-Blocks	1	0	0	1
8818418	mbeddr.arduino	https://github.com/coolya/mbeddr.arduino	0	2	0	2
8826947	meteor	https://github.com/sdarnell/meteor	1	0	0	1
8827950	Kit	https://github.com/bdkjones/Kit	1	0	0	1
8831394	ember-model	https://github.com/ebryn/ember-model	3	0	0	3
8834999	grunt-svgmin	https://github.com/sindresorhus/grunt-svgmin	1	0	0	1
8835721	DAT255	https://github.com/morganericsson/DAT255	1	1	0	2
8838066	TypeOver	https://github.com/KomodoOpenLab/TypeOver	0	2	0	2
8845187	imexport	https://github.com/bittion/imexport	1	0	0	1
8849460	fox	https://github.com/azer/fox	1	0	0	1
8850148	ebm	https://github.com/foxbow/ebm	1	0	0	1
8861865	webkit-webcl	https://github.com/uebquite/webkit-webcl	1	0	0	1
8864131	sponge.php	https://github.com/abeaumet/sponge.php	1	0	0	1
8868646	Minilla	https://github.com/tokuhirom/Minilla	1	0	0	1
8869463	openfl	https://github.com/openfl/openfl	2	0	0	2
8877512	ListViewAnimations	https://github.com/nhaarman/ListViewAnimations	2	0	0	2
8879340	bootstrap	https://github.com/Syonet/bootstrap	1	0	0	1
8882800	pi	https://github.com/pi-engine/pi	1	1	0	2
8885160	oglplus	https://github.com/matus-chochlik/oglplus	1	0	0	1
8887856	cf-services-contrib-release	https://github.com/cloudfoundry/cf-services-contrib-release	1	0	0	1
8889192	railsgoat	https://github.com/OWASP/railsgoat	1	0	0	1
8891992	httmock	https://github.com/patrys/httmock	0	1	0	1
8893510	igroups	https://github.com/andreioprisan/igroups	0	1	0	1
8910064	observe-shim	https://github.com/KapIT/observe-shim	1	0	0	1
8912617	commafeed	https://github.com/Athou/commafeed	0	1	0	1
8928286	VendorBranchForFreeBSDonHyper-V	https://github.com/FreeBSDonHyper-V/VendorBranchForFreeBSDonHyper-V	1	0	0	1
8935303	dropcenter	https://github.com/ldleman/dropcenter	0	0	1	1
8938683	ruby_lib	https://github.com/appium/ruby_lib	0	5	0	5
8955203	bootstrap-checkbox	https://github.com/montrezorro/bootstrap-checkbox	0	1	0	1
8962069	angularFire	https://github.com/firebase/angularFire	1	0	0	1
8962813	homebrew-tap	https://github.com/darinmorrison/homebrew-tap	2	0	0	2
8963857	angular-gm	https://github.com/dylanfprice/angular-gm	2	1	0	3
8964503	OmnomIRC3	https://github.com/Omnimaga/OmnomIRC3	0	5	0	5
8965446	slick-joda-mapper	https://github.com/tototoshi/slick-joda-mapper	1	0	0	1
8966356	packer	https://github.com/mitchellh/packer	1	1	0	2
8966669	yamj-v3	https://github.com/YAMJ/yamj-v3	0	1	0	1
8969192	xeHentai	https://github.com/fffonion/xeHentai	1	0	0	1
8969447	acid	https://github.com/dw/acid	2	0	0	2
8975403	cwrufwf	https://github.com/rossnanop/cwrufwf	1	0	0	1
8977933	amr-guidelines	https://github.com/kevincrawfordknight/amr-guidelines	0	2	0	2
8983001	dbfutil	https://github.com/dogtato/dbfutil	1	0	0	1
8994722	Awesome-Facebook-Widget	https://github.com/kayoub5/Awesome-Facebook-Widget	1	0	0	1
8994723	NDEx-Site	https://github.com/cytoscape/NDEx-Site	1	7	0	8
9001049	dotfiles	https://github.com/pfraces/dotfiles	7	0	0	7
9002864	wukong-darjeeling	https://github.com/wukong-m2m/wukong-darjeeling	1	0	0	1
9003378	pyRigolWFM	https://github.com/mabl/pyRigolWFM	0	1	0	1
9005580	yaml-config	https://github.com/selectel/yaml-config	0	2	0	2
9009108	project-stub	https://github.com/mdevils/project-stub	1	0	0	1
9017955	refactor_this	https://github.com/Devbootcamp/refactor_this	0	2	0	2
9021497	Client	https://github.com/CasparCG/Client	1	0	0	1
9024450	Server	https://github.com/CasparCG/Server	1	0	0	1
9026453	OpenStack-Grizzly-Install-Guide	https://github.com/mseknibilel/OpenStack-Grizzly-Install-Guide	1	0	0	1
9034608	behat-mink-mac	https://github.com/alberto56/behat-mink-mac	1	0	0	1
9037027	firepad	https://github.com/firebase/firepad	1	0	0	1
9043124	gaffer	https://github.com/ImageEngine/gaffer	0	1	0	1
9044752	redwaves	https://github.com/ferlinhusky/redwaves	0	1	0	1
9048279	ardb	https://github.com/yinqiwen/ardb	1	0	0	1
9050033	MindBodyAPIBundle	https://github.com/wmds/MindBodyAPIBundle	0	2	0	2
9053997	linguagem-de-programacao-i-livro	https://github.com/edusantana/linguagem-de-programacao-i-livro	1	0	0	1
9054462	phi-search	https://github.com/zk-phi/phi-search	0	1	0	1
9057952	acado	https://github.com/acado/acado	0	1	0	1
9066647	collabit	https://github.com/ehaughee/collabit	2	3	0	5
9067128	Leed-market	https://github.com/ldleman/Leed-market	1	0	0	1
9067707	magic-summary-tool	https://github.com/frabcus/magic-summary-tool	1	0	0	1
9068420	webRTCCopy	https://github.com/erbbysam/webRTCCopy	3	0	0	3
9070674	Subliminal	https://github.com/inkling/Subliminal	2	0	0	2
9072237	nw-tools	https://github.com/owenc4a4/nw-tools	2	0	0	2
9072799	IPAS	https://github.com/Xosofox/IPAS	1	0	0	1
9074548	H2GIS	https://github.com/irstv/H2GIS	0	1	0	1
9075226	megam_play	https://github.com/indykish/megam_play	2	0	0	2
9076049	scientific_library	https://github.com/the-virtual-brain/scientific_library	1	0	0	1
9076436	Kernel-Tuner	https://github.com/pedja1/Kernel-Tuner	1	0	0	1
9078279	cabildo-abierto	https://github.com/ciudadanointeligente/cabildo-abierto	0	1	0	1
9081529	yota	https://github.com/icook/yota	0	1	0	1
9081590	csv-validator	https://github.com/digital-preservation/csv-validator	1	1	0	2
9086852	issues	https://github.com/cmangos/issues	1	0	0	1
9090323	zookeeper-lite	https://github.com/lisaglendenning/zookeeper-lite	0	1	0	1
9091970	hydra	https://github.com/projecthydra/hydra	1	0	0	1
9094192	pytest-bdd	https://github.com/olegpidsadnyi/pytest-bdd	1	0	0	1
9095070	rallydev	https://github.com/crc83/rallydev	2	2	0	4
9098633	tigerp	https://github.com/feiyunzhou/tigerp	1	0	0	1
9100049	gsync	https://github.com/iwonbigbro/gsync	1	0	0	1
9100970	redmine_loader	https://github.com/m0n9oose/redmine_loader	1	2	0	3
9103133	observe-utils	https://github.com/KapIT/observe-utils	1	0	0	1
9110788	feedback	https://github.com/mdo/feedback	1	1	0	2
9126133	sun	https://github.com/phetsims/sun	2	0	0	2
9127684	KNACSS	https://github.com/raphaelgoetter/KNACSS	1	0	0	1
9131292	Laravel-MongoDB	https://github.com/jenssegers/Laravel-MongoDB	0	3	0	3
9131639	Karkat	https://github.com/tetrapus/Karkat	1	0	0	1
9131969	nodezero	https://github.com/nodiscc/nodezero	1	0	0	1
9132531	backbone.modal	https://github.com/awkward/backbone.modal	0	1	0	1
9136015	service.openelec.settings	https://github.com/OpenELEC/service.openelec.settings	1	1	0	2
9136866	JEM-Project	https://github.com/jemproject/JEM-Project	1	2	1	4
9137798	RWM	https://github.com/tarosuke/RWM	1	0	0	1
9140692	wordpress-theme	https://github.com/nveyak/wordpress-theme	2	7	0	9
9146056	restpack_serializer	https://github.com/RestPack/restpack_serializer	1	0	0	1
9149071	app-anno	https://github.com/david-kennan/app-anno	1	2	0	3
9154423	goamz	https://github.com/crowdmob/goamz	0	3	0	3
9157654	human_services_finder	https://github.com/codeforamerica/human_services_finder	1	0	0	1
9158101	vim-dispatch	https://github.com/tpope/vim-dispatch	2	2	0	4
9158654	Snap.js	https://github.com/jakiestfu/Snap.js	1	0	0	1
9158764	Broadband.Editing	https://github.com/agrc/Broadband.Editing	1	0	0	1
9161555	A-Company-MVP3	https://github.com/bcato/A-Company-MVP3	1	0	0	1
9163041	platen	https://github.com/AlexTatiyants/platen	2	0	0	2
9163640	shields	https://github.com/sprk/shields	0	4	0	4
9166737	JobBundle	https://github.com/lilweb/JobBundle	1	0	0	1
9169524	shared	https://github.com/theodi/shared	2	0	0	2
9171671	tequila	https://github.com/dremoor/tequila	1	0	0	1
9174850	grape-active_model_serializers	https://github.com/jrhe/grape-active_model_serializers	0	1	0	1
9175924	helios	https://github.com/helios-framework/helios	1	0	0	1
9179529	stapfen	https://github.com/lookout/stapfen	0	2	0	2
9183498	mathflowy	https://github.com/thricedotted/mathflowy	1	0	0	1
9183735	discore-interface	https://github.com/discore/discore-interface	0	1	0	1
9184554	CMS	https://github.com/Kooboo/CMS	1	0	0	1
9185758	zrender	https://github.com/ecomfe/zrender	1	2	0	3
9189857	ec2_disk_monit	https://github.com/vireshas/ec2_disk_monit	4	7	0	11
9190413	wechat-php-sdk	https://github.com/dodgepudding/wechat-php-sdk	1	0	0	1
9191532	bootstrap-maxlength	https://github.com/mimo84/bootstrap-maxlength	0	1	0	1
9193949	poche	https://github.com/inthepoche/poche	6	4	0	10
9196478	jentrata	https://github.com/jentrata/jentrata	0	2	0	2
9197002	canjs.com	https://github.com/bitovi/canjs.com	1	1	0	2
9201514	Translations	https://github.com/projectfork/Translations	1	0	0	1
9201867	Queso-Multisite	https://github.com/claytical/Queso-Multisite	0	2	0	2
9205821	crowdmap-issues	https://github.com/ushahidi/crowdmap-issues	0	1	0	1
9209540	Bombardier	https://github.com/dermeister0/Bombardier	1	0	0	1
9210604	restangular	https://github.com/mgonto/restangular	3	4	0	7
9211453	apps	https://github.com/uws-eresearch/apps	0	6	0	6
9215706	Nsl-Website-Engine	https://github.com/NslWebsiteEngine/Nsl-Website-Engine	0	2	0	2
9219388	RedReader	https://github.com/QuantumBadger/RedReader	2	0	0	2
9221093	WarrantyNowVoid.com	https://github.com/WarrantyNowVoid/WarrantyNowVoid.com	5	6	0	11
9221119	geonode	https://github.com/ROGUE-JCTD/geonode	0	1	0	1
9222895	ChromeGestures	https://github.com/os0x/ChromeGestures	1	0	0	1
9226519	PHP-Neoform	https://github.com/neoform/PHP-Neoform	1	0	0	1
9226653	bootstrap-wysiwyg	https://github.com/mindmup/bootstrap-wysiwyg	1	0	0	1
9233796	playscript-mono	https://github.com/playscript/playscript-mono	1	1	0	2
9239530	Modular-Force-Field-System	https://github.com/calclavia/Modular-Force-Field-System	2	0	0	2
9239574	joomla	https://github.com/schroed/joomla	1	0	0	1
9242061	ad-ldap-connector	https://github.com/auth0/ad-ldap-connector	0	1	0	1
9242293	HElib	https://github.com/shaih/HElib	1	1	1	3
9245041	glosar	https://github.com/JohnTheDaniel/glosar	1	0	0	1
9249778	curate	https://github.com/ndlib/curate	1	0	0	1
9250789	openflow-openwrt	https://github.com/CPqD/openflow-openwrt	1	0	0	1
9250933	peepoltv-web	https://github.com/peepoltv/peepoltv-web	0	9	0	9
9250944	peepoltv-api	https://github.com/peepoltv/peepoltv-api	0	2	0	2
9252144	wp-better-attachments	https://github.com/DHolloran/wp-better-attachments	0	1	0	1
9254109	SourceMod.js	https://github.com/Matheus28/SourceMod.js	1	0	0	1
9255495	stringer	https://github.com/swanson/stringer	1	0	0	1
9265076	app	https://github.com/DemocracyOS/app	4	0	0	4
9265294	mackup	https://github.com/lra/mackup	1	0	0	1
9266768	pacit	https://github.com/jonstout/pacit	0	2	0	2
9269283	express	https://github.com/benstof/express	6	2	0	8
9270423	pagoda	https://github.com/alagu/pagoda	1	0	0	1
9270493	how_slow	https://github.com/jefflunt/how_slow	1	0	0	1
9271598	nodeclipse-1	https://github.com/Nodeclipse/nodeclipse-1	2	0	0	2
9278129	Contiki	https://github.com/Varcain/Contiki	1	0	0	1
9279386	idea-php-symfony2-plugin	https://github.com/adrienbrault/idea-php-symfony2-plugin	1	3	0	4
9280589	Enhanced_Steam	https://github.com/jshackles/Enhanced_Steam	1	0	0	1
9280870	tasksched	https://github.com/ningke/tasksched	1	1	0	2
9290981	bookwriting	https://github.com/duhlig/bookwriting	0	1	0	1
9291293	brotherhood	https://github.com/newbdez33/brotherhood	13	7	0	20
9292525	tprj-msi-ss13	https://github.com/magerhar/tprj-msi-ss13	5	0	0	5
9299413	DirectResize2	https://github.com/Setest/DirectResize2	1	0	0	1
9301414	hledger	https://github.com/simonmichael/hledger	1	0	0	1
9306568	WordPress-Android	https://github.com/wordpress-mobile/WordPress-Android	2	0	0	2
9307757	apm_planner	https://github.com/diydrones/apm_planner	1	0	0	1
9310201	brasil.gov.temas	https://github.com/plonegovbr/brasil.gov.temas	0	6	0	6
9310511	bizfriendly-api	https://github.com/codeforamerica/bizfriendly-api	1	0	0	1
9311021	xdomain	https://github.com/jpillora/xdomain	2	1	0	3
9314961	silverstripe-mandrill	https://github.com/lanks/silverstripe-mandrill	0	1	0	1
9320732	yiinitializr-intermediate	https://github.com/tonydspaniard/yiinitializr-intermediate	1	0	0	1
9321062	arch.linux.org.tw	https://github.com/linux-taiwan/arch.linux.org.tw	0	1	0	1
9322348	yiinitializr-advanced	https://github.com/tonydspaniard/yiinitializr-advanced	1	0	0	1
9326337	myContest	https://github.com/highergroundstudio/myContest	1	0	0	1
9332725	bookmarks	https://github.com/owncloud/bookmarks	1	0	0	1
9332832	pareto	https://github.com/superbobry/pareto	1	0	0	1
9333894	golismero	https://github.com/cr0hn/golismero	1	0	0	1
9338902	openshift-python27-flask-quickstart	https://github.com/mrunalp/openshift-python27-flask-quickstart	1	0	0	1
9340913	butterfly	https://github.com/ButterFly-Broadcast/butterfly	2	0	0	2
9348908	cabinet	https://github.com/cabinet/cabinet	1	0	0	1
9349217	rCharts	https://github.com/ramnathv/rCharts	1	1	0	2
9351133	Laravel-MtHaml	https://github.com/villimagg/Laravel-MtHaml	1	0	0	1
9351691	genesis	https://github.com/cznweb/genesis	1	0	0	1
9351974	concrete5-bootstrapcache	https://github.com/bashaus/concrete5-bootstrapcache	0	1	0	1
9353954	SunApp	https://github.com/marcelstoer/SunApp	0	1	0	1
9357067	tools	https://github.com/Polymer/tools	1	1	0	2
9360778	vincent	https://github.com/wrobstory/vincent	1	0	0	1
9361806	kickass-slider	https://github.com/jashwant/kickass-slider	1	0	0	1
9362971	flesh	https://github.com/Chandler/flesh	4	5	1	10
9368729	calendar	https://github.com/owncloud/calendar	0	1	0	1
9373486	team	https://github.com/Sidnicious/team	1	0	0	1
9388953	leedReader	https://github.com/barbogogo/leedReader	4	0	0	4
9389060	openstack_grizzly_install	https://github.com/jedipunkz/openstack_grizzly_install	0	1	0	1
9392176	fof	https://github.com/akeeba/fof	0	1	0	1
9395939	ZoneMinder	https://github.com/ZoneMinder/ZoneMinder	1	0	0	1
9396060	web-toolkit	https://github.com/skyglobal/web-toolkit	0	1	0	1
9409945	awesomium-pub	https://github.com/awesomium/awesomium-pub	1	0	0	1
9418501	ModernBB	https://github.com/ModernBB/ModernBB	3	3	0	6
9418553	coinmap	https://github.com/prusnak/coinmap	0	1	0	1
9419557	mfaktx-controller	https://github.com/Mini-Geek/mfaktx-controller	2	2	0	4
9426192	PlexConnect	https://github.com/iBaa/PlexConnect	2	2	0	4
9431399	doli-mobile-android	https://github.com/jingdoli/doli-mobile-android	0	7	0	7
9433030	bp-cli	https://github.com/boonebgorges/bp-cli	1	0	0	1
9448646	talks-proposals	https://github.com/Toulouse-rb/talks-proposals	1	0	0	1
9448900	studip-RichTextPlugin	https://github.com/zabbarob/studip-RichTextPlugin	1	0	0	1
9450431	VMI_Billing	https://github.com/Wesco/VMI_Billing	3	0	0	3
9451506	caleydo	https://github.com/Caleydo/caleydo	4	3	0	7
9456724	Porpoise	https://github.com/PurposeOpen/Porpoise	1	0	0	1
9459049	rpsltool	https://github.com/rfc1036/rpsltool	1	0	0	1
9460588	worldtree	https://github.com/gurupras/worldtree	2	1	0	3
9462835	brasil.gov.tiles	https://github.com/plonegovbr/brasil.gov.tiles	1	1	0	2
9465623	ft-index	https://github.com/Tokutek/ft-index	1	0	0	1
9466422	geolocater	https://github.com/rldhont/geolocater	1	0	0	1
9467421	vis	https://github.com/almende/vis	1	0	0	1
9467592	validator	https://github.com/niceue/validator	1	0	0	1
9474487	basebuilder	https://github.com/flaviamissi/basebuilder	1	0	0	1
9475692	fartscroll.js	https://github.com/theonion/fartscroll.js	1	0	0	1
9477941	finalterm	https://github.com/p-e-w/finalterm	2	1	0	3
9490648	cube	https://github.com/cubensx/cube	0	2	0	2
9493091	AddressParser.NET	https://github.com/fschoening/AddressParser.NET	1	0	0	1
9497680	redmine_workload	https://github.com/JostBaron/redmine_workload	1	1	0	2
9500058	homebrew-cv	https://github.com/fran6co/homebrew-cv	0	1	0	1
9506449	FFR	https://github.com/jbailey2010/FFR	6	0	0	6
9509125	ft-engine	https://github.com/Tokutek/ft-engine	3	0	0	3
9511040	ogo	https://github.com/jonstout/ogo	2	1	0	3
9511940	fixmystreet	https://github.com/Sinar/fixmystreet	1	0	0	1
9521499	grunt-html-build	https://github.com/spatools/grunt-html-build	0	1	0	1
9521528	ichnaea	https://github.com/mozilla/ichnaea	1	0	0	1
9524997	glfw	https://github.com/glfw/glfw	3	1	0	4
9529585	brackets-code-folding	https://github.com/thehogfather/brackets-code-folding	1	0	0	1
9533384	lineman-angular-template	https://github.com/davemo/lineman-angular-template	1	0	0	1
9533537	commoner	https://github.com/benjamn/commoner	0	1	0	1
9533559	cameleon	https://github.com/Entropic-Synergies/cameleon	1	0	0	1
9544821	panthera	https://github.com/webnull/panthera	1	0	0	1
9551576	shopp	https://github.com/ingenesis/shopp	3	8	1	12
9552615	devopsjs	https://github.com/equalitie/devopsjs	1	0	0	1
9556181	postgresql-maven-plugin	https://github.com/adrianboimvaser/postgresql-maven-plugin	1	1	0	2
9557101	android-app	https://github.com/fahrgemeinschaft/android-app	1	0	0	1
9559458	Inmovitek	https://github.com/ENGINETEC/Inmovitek	1	1	0	2
9563270	Firetext	https://github.com/Codexa/Firetext	1	0	0	1
9563482	Sammelbox	https://github.com/jeromewagener/Sammelbox	0	1	0	1
9566455	space	https://github.com/nudgepad/space	0	1	0	1
9566623	nudgepad	https://github.com/nudgepad/nudgepad	2	1	0	3
9568894	nengo	https://github.com/ctn-waterloo/nengo	1	5	0	6
9569227	devise_saml_authenticatable	https://github.com/apokalipto/devise_saml_authenticatable	0	1	0	1
9574271	webot-douban-event	https://github.com/node-webot/webot-douban-event	1	1	0	2
9575207	noflo-groups	https://github.com/noflo/noflo-groups	0	1	0	1
9579367	dill	https://github.com/mojotech/dill	2	0	0	2
9581074	LunaChat	https://github.com/ucchyocean/LunaChat	2	0	0	2
9582785	ESF-MU-Portal	https://github.com/kanei/ESF-MU-Portal	1	0	0	1
9582935	lee-dohm.github.io	https://github.com/lee-dohm/lee-dohm.github.io	1	0	0	1
9583969	noflo-objects	https://github.com/noflo/noflo-objects	0	1	0	1
9595023	ImageInOsm	https://github.com/NaturalSolutions/ImageInOsm	0	2	0	2
9602361	31-Days-of-Windows-8	https://github.com/BeyondVincent/31-Days-of-Windows-8	1	0	0	1
9603084	Board	https://github.com/rhsu/Board	1	0	0	1
9603240	pure	https://github.com/yui/pure	1	1	0	2
9603889	NodeBB	https://github.com/designcreateplay/NodeBB	1	4	0	5
9608218	OrdnungJS	https://github.com/mariusGundersen/OrdnungJS	1	0	0	1
9609180	pupa	https://github.com/opencivicdata/pupa	0	1	0	1
9609413	googledrawing	https://github.com/statueofmike/googledrawing	1	1	0	2
9610997	PHPCodeIntel	https://github.com/deweller/PHPCodeIntel	1	2	0	3
9613201	www	https://github.com/MovLib/www	0	1	0	1
9616810	onecuppadesign	https://github.com/apnerve/onecuppadesign	1	0	0	1
9618364	skippy-xd	https://github.com/richardgv/skippy-xd	1	0	0	1
9618974	biblio	https://github.com/amitaibu/biblio	1	3	0	4
9619510	FeedEx	https://github.com/HoloAddict/FeedEx	1	2	0	3
9625667	spiro	https://github.com/NakedObjectsGroup/spiro	1	0	0	1
9626618	game-modes	https://github.com/maniaplanet/game-modes	1	0	0	1
9627539	cfn-pyplates	https://github.com/seandst/cfn-pyplates	1	0	0	1
9631074	azure-sdk-tools-samples	https://github.com/WindowsAzure/azure-sdk-tools-samples	4	0	0	4
9632922	OliWeb	https://github.com/m2ware/OliWeb	0	1	0	1
9639981	xctool	https://github.com/facebook/xctool	2	0	0	2
9644208	jose	https://github.com/gree/jose	0	1	0	1
9645753	gridsite	https://github.com/CESNET/gridsite	0	1	0	1
9652998	behave	https://github.com/demoiselle/behave	1	1	0	2
9656466	p4.el	https://github.com/gareth-rees/p4.el	2	2	0	4
9663145	fqtd	https://github.com/anhvupham/fqtd	6	4	0	10
9667564	La-Familia-WoW-4.3.4	https://github.com/Avangard/La-Familia-WoW-4.3.4	1	0	0	1
9669321	sb-ruter	https://github.com/evenh/sb-ruter	1	0	0	1
9672130	phplist	https://github.com/michield/phplist	0	1	0	1
9672786	Prepros	https://github.com/sbspk/Prepros	9	7	1	17
9677593	morphia	https://github.com/mongodb/morphia	1	3	0	4
9680258	eyebrowse	https://github.com/crcn/eyebrowse	1	0	0	1
9680877	monocopy	https://github.com/tailrecursion/monocopy	1	0	0	1
9681561	ripple-lib	https://github.com/ripple/ripple-lib	2	2	1	5
9682103	Test-Chado	https://github.com/dictyBase/Test-Chado	1	0	0	1
9683876	nZEDb	https://github.com/nZEDb/nZEDb	0	1	0	1
9685405	Issues	https://github.com/OvercastNetwork/Issues	2	3	0	5
9686230	CT406GroupProject	https://github.com/spawn170/CT406GroupProject	0	1	0	1
9688658	blog	https://github.com/henix/blog	1	0	0	1
9693534	pdns	https://github.com/PowerDNS/pdns	1	6	0	7
9695954	tern_for_sublime	https://github.com/marijnh/tern_for_sublime	1	0	0	1
9696392	Upcoming	https://github.com/TeehanLax/Upcoming	1	0	0	1
9705216	howconf	https://github.com/mattdsteele/howconf	1	0	0	1
9709563	summernote	https://github.com/HackerWins/summernote	4	0	0	4
9732406	g4he	https://github.com/g4he/g4he	2	1	0	3
9741924	OSMonitor	https://github.com/eolwral/OSMonitor	1	0	0	1
9745484	openwifi-server	https://github.com/openwifi/openwifi-server	1	0	0	1
9749639	margarine	https://github.com/raxsavvy/margarine	1	0	0	1
9750564	SpaceAdvocatesWebsite	https://github.com/SpaceAdvocates/SpaceAdvocatesWebsite	4	2	0	6
9750760	moodle-mod_chairman	https://github.com/oohoo/moodle-mod_chairman	1	0	0	1
9753207	rouster	https://github.com/chorankates/rouster	0	1	0	1
9753225	wight	https://github.com/heynemann/wight	1	1	0	2
9758073	helium	https://github.com/TheGreenBox/helium	0	1	0	1
9758146	docpad-plugin-minicms	https://github.com/jeremyfa/docpad-plugin-minicms	1	0	0	1
9758300	fotorama	https://github.com/artpolikarpov/fotorama	1	0	0	1
9759670	vagrant-vsphere	https://github.com/nsidc/vagrant-vsphere	1	0	0	1
9760557	node-continuation-local-storage	https://github.com/othiym23/node-continuation-local-storage	2	0	0	2
9762559	trac-config	https://github.com/twisted-infra/trac-config	1	0	0	1
9764423	cm-xtended	https://github.com/M66B/cm-xtended	1	1	0	2
9765773	PiAUISuite	https://github.com/StevenHickson/PiAUISuite	1	0	0	1
9766101	service	https://github.com/freeedu/service	1	0	0	1
9767352	MobLimiter	https://github.com/CoreNetwork/MobLimiter	1	1	0	2
9768131	Aerosketch	https://github.com/cshum/Aerosketch	1	0	0	1
9769041	Tesseract-OCR-iOS	https://github.com/gali8/Tesseract-OCR-iOS	0	1	0	1
9772180	openstack-manuals-convert	https://github.com/redhat-openstack/openstack-manuals-convert	0	0	1	1
9772827	ocaml-ctypes	https://github.com/ocamllabs/ocaml-ctypes	0	1	0	1
9776965	gnawts	https://github.com/hpc/gnawts	1	0	0	1
9777512	asset-pipeline	https://github.com/bertramdev/asset-pipeline	1	1	0	2
9778184	aicontest	https://github.com/xupyprmv/aicontest	0	1	0	1
9779536	ggvis	https://github.com/rstudio/ggvis	1	0	0	1
9781640	kernel	https://github.com/KnightSoft/kernel	0	1	0	1
9784365	Mining-the-Social-Web-2nd-Edition	https://github.com/ptwobrussell/Mining-the-Social-Web-2nd-Edition	1	1	0	2
9784463	blog	https://github.com/Gaubee/blog	1	0	0	1
9785559	spring-data-jdbc-codegen	https://github.com/kalyanmulampaka/spring-data-jdbc-codegen	1	0	0	1
9785722	fedena	https://github.com/joneslee85/fedena	2	1	0	3
9786168	m.sc-thesis	https://github.com/leodido/m.sc-thesis	0	4	0	4
9787281	string-edit.el	https://github.com/magnars/string-edit.el	1	0	0	1
9792989	php_riak	https://github.com/TriKaspar/php_riak	1	0	0	1
9794046	lumail	https://github.com/skx/lumail	0	3	0	3
9794721	owaka	https://github.com/tmuguet/owaka	0	1	0	1
9795883	nedb	https://github.com/louischatriot/nedb	1	3	0	4
9797673	xtc	https://github.com/MarcDiethelm/xtc	1	0	0	1
9797857	elasticsearch-HQ	https://github.com/royrusso/elasticsearch-HQ	0	1	0	1
9806740	timeball	https://github.com/kev40293/timeball	1	0	0	1
9807471	testLucene	https://github.com/DBheart/testLucene	2	0	0	2
9820094	Github-Omnibox	https://github.com/ProLoser/Github-Omnibox	1	0	0	1
9821517	DragonStone	https://github.com/RedactedGames/DragonStone	6	0	0	6
9823632	minion-frontend	https://github.com/mozilla/minion-frontend	0	1	0	1
9824342	test	https://github.com/sbezborotest/test	69	37	13	119
9830981	witower	https://github.com/uicestone/witower	1	0	0	1
9831253	SIAlertView	https://github.com/Sumi-Interactive/SIAlertView	1	0	0	1
9832516	MAS	https://github.com/MikeR13/MAS	13	6	0	19
9832787	Leaflet.Snap	https://github.com/makinacorpus/Leaflet.Snap	0	1	0	1
9835188	training	https://github.com/miyabihito/training	2	2	0	4
9835917	databus	https://github.com/deanhiller/databus	1	0	0	1
9838810	angular-ui-bootstrap	https://github.com/webjars/angular-ui-bootstrap	1	0	0	1
9839791	mobile	https://github.com/MapofLife/mobile	1	0	0	1
9845551	angular-google-analytics	https://github.com/revolunet/angular-google-analytics	1	0	0	1
9847762	zephyros	https://github.com/sdegutis/zephyros	1	4	1	6
9849074	UpStage2013	https://github.com/AUTUpStageTeam/UpStage2013	18	21	0	39
9851384	haskell-src-exts	https://github.com/haskell-suite/haskell-src-exts	2	0	0	2
9851649	Thinktecture.AuthorizationServer	https://github.com/thinktecture/Thinktecture.AuthorizationServer	0	2	0	2
9852660	legislator	https://github.com/kikoval/legislator	1	0	0	1
9859154	json-api	https://github.com/json-api/json-api	1	0	0	1
9859620	Bowtie	https://github.com/wallarelvo/Bowtie	0	1	0	1
9868114	meteor-accounts-ui-bootstrap-3	https://github.com/mangasocial/meteor-accounts-ui-bootstrap-3	1	0	0	1
9870804	JSON-Service	https://github.com/SchedulesDirect/JSON-Service	1	0	0	1
9873034	line-chart	https://github.com/angular-d3/line-chart	1	0	0	1
9873551	polymer-ui-elements	https://github.com/Polymer/polymer-ui-elements	0	1	0	1
9878258	PLUG-Wall	https://github.com/PantherLinuxUserGroup/PLUG-Wall	1	2	0	3
9880797	berkshelf-api	https://github.com/RiotGames/berkshelf-api	0	1	0	1
9886066	tbot-800	https://github.com/ohyecloudy/tbot-800	1	0	0	1
9886107	Geotrek	https://github.com/makinacorpus/Geotrek	3	0	0	3
9887009	contacts	https://github.com/owncloud/contacts	0	1	0	1
9888045	MarkerGoogleMaps	https://github.com/AgelxNash/MarkerGoogleMaps	1	0	0	1
9889328	iszom	https://github.com/lilahagyma/iszom	0	1	0	1
9892409	AndroidDownloadManger	https://github.com/matsuhiro/AndroidDownloadManger	0	1	0	1
9894918	thecollectors	https://github.com/Seneca-CDOT/thecollectors	0	2	0	2
9895954	perma	https://github.com/harvard-lil/perma	2	0	0	2
9909566	whois	https://github.com/RIPE-NCC/whois	0	1	0	1
9910612	glow	https://github.com/hpicgs/glow	1	0	0	1
9915827	lambdanative	https://github.com/part-cw/lambdanative	1	0	0	1
9916505	harvey	https://github.com/tschwecke/harvey	2	0	0	2
9919790	pipes-network	https://github.com/k0001/pipes-network	1	1	0	2
9921723	cl-sdl2	https://github.com/lispgames/cl-sdl2	0	1	0	1
9922918	r10k	https://github.com/acidprime/r10k	0	1	0	1
9927726	dashing	https://github.com/DashMedia/dashing	3	0	0	3
9928792	wscn	https://github.com/wallstreetcn/wscn	1	0	0	1
9932168	Flat-UI-Pro-Support	https://github.com/designmodo/Flat-UI-Pro-Support	3	0	0	3
9937417	DomniklShellOutBundle	https://github.com/domnikl/DomniklShellOutBundle	1	0	0	1
9937873	Artifice	https://github.com/Shukaro/Artifice	0	2	0	2
9941419	vbWidgets	https://github.com/Kbre/vbWidgets	1	0	0	1
9941514	foss4g	https://github.com/barryrowlingson/foss4g	0	2	0	2
9944156	balaio	https://github.com/scieloorg/balaio	9	3	0	12
9956563	RequestVehicleApp	https://github.com/dream89/RequestVehicleApp	2	1	0	3
9957180	satir	https://github.com/jhigman/satir	1	0	0	1
9957772	opensips	https://github.com/OpenSIPS/opensips	1	0	0	1
9960426	project-open-data.github.io	https://github.com/project-open-data/project-open-data.github.io	1	1	0	2
9969628	libre	https://github.com/commonwealth-of-puerto-rico/libre	1	0	0	1
9970079	arcgis-viewer-builder-flex	https://github.com/Esri/arcgis-viewer-builder-flex	1	1	0	2
9972650	bauble.api	https://github.com/Bauble/bauble.api	1	0	0	1
9972819	pyberry	https://github.com/braxton-schafer/pyberry	1	0	0	1
9973787	AEGeAn	https://github.com/standage/AEGeAn	1	2	0	3
9979119	gwpy	https://github.com/gwpy/gwpy	3	0	0	3
9981835	webcl-validator	https://github.com/KhronosGroup/webcl-validator	0	2	0	2
9983223	lazy.js	https://github.com/dtao/lazy.js	1	0	0	1
9983916	f4v	https://github.com/mjvesa/f4v	4	1	0	5
9988978	chipper	https://github.com/phetsims/chipper	1	1	0	2
9989526	geojson.io	https://github.com/mapbox/geojson.io	3	5	0	8
9991771	pymbar	https://github.com/choderalab/pymbar	3	0	0	3
9993226	coinbase-php	https://github.com/coinbase/coinbase-php	1	0	0	1
9996947	ngo20map6	https://github.com/bigeyex/ngo20map6	5	0	0	5
9998592	PlataJumperSDL	https://github.com/Snowl/PlataJumperSDL	0	1	0	1
10001352	KinectMiniGames	https://github.com/speedy901990/KinectMiniGames	1	4	1	6
10002027	node-gh	https://github.com/eduardolundgren/node-gh	8	6	0	14
10003278	marscity	https://github.com/ForceField-IndieGames/marscity	0	1	0	1
10003934	grow3.js	https://github.com/filgf/grow3.js	1	0	0	1
10004049	grunt-pages	https://github.com/CabinJS/grunt-pages	1	0	0	1
10005996	grails-melody-plugin	https://github.com/evernat/grails-melody-plugin	1	0	0	1
10006304	abracad	https://github.com/damballa/abracad	1	1	0	2
10008015	totoro-server	https://github.com/totorojs/totoro-server	1	0	0	1
10012507	mcomaster	https://github.com/ajf8/mcomaster	0	2	0	2
10015050	16plus.jsb.be	https://github.com/16plus/16plus.jsb.be	1	0	0	1
10024954	opencbs	https://github.com/PavelBastov/opencbs	0	1	0	1
10025737	PSReadLine	https://github.com/lzybkr/PSReadLine	2	0	0	2
10026991	office	https://github.com/squeen/office	1	0	0	1
10027297	glow-utils	https://github.com/hpicgs/glow-utils	1	0	0	1
10030957	borges	https://github.com/johm/borges	1	0	0	1
10031258	TCC_VERONICA	https://github.com/veronicapinto/TCC_VERONICA	0	2	0	2
10032479	ScrollsModLoader	https://github.com/Drakulix/ScrollsModLoader	1	0	0	1
10034727	half-pipe	https://github.com/d-i/half-pipe	4	4	0	8
10040379	v8ppc	https://github.com/andrewlow/v8ppc	1	0	0	1
10041543	http2-katana	https://github.com/MSOpenTech/http2-katana	1	1	0	2
10041891	picl-idp	https://github.com/mozilla/picl-idp	5	1	0	6
10050171	OutSource	https://github.com/zyslovely/OutSource	1	0	0	1
10056886	ukrcms	https://github.com/ukrcms/ukrcms	1	4	0	5
10057361	Yakutia	https://github.com/freddejones/Yakutia	1	3	0	4
10057866	reddit	https://github.com/new-day-international/reddit	0	3	0	3
10057936	picasso	https://github.com/square/picasso	1	0	0	1
10060907	OpenDataRise	https://github.com/opendatatrentino/OpenDataRise	2	1	0	3
10062396	ohana-api	https://github.com/codeforamerica/ohana-api	1	0	0	1
10067479	eclipse-typescript	https://github.com/palantir/eclipse-typescript	3	3	0	6
10068482	openfl-native	https://github.com/openfl/openfl-native	1	0	0	1
10070134	grunt-explainjs	https://github.com/collinforrester/grunt-explainjs	1	0	0	1
10071860	RocketMQ	https://github.com/alibaba/RocketMQ	0	1	0	1
10078802	iteam-se.docpad	https://github.com/Iteam1337/iteam-se.docpad	1	11	0	12
10081455	generator-gruntplugin	https://github.com/yeoman/generator-gruntplugin	1	0	0	1
10082990	vm-manager	https://github.com/stepping-stone/vm-manager	1	0	0	1
10091574	hopscotch	https://github.com/linkedin/hopscotch	1	0	0	1
10096049	velimonde	https://github.com/gapato/velimonde	0	1	0	1
10097962	rnbn	https://github.com/JNCC-UK/rnbn	0	1	0	1
10098176	bsc-resources	https://github.com/basecondition/bsc-resources	1	0	0	1
10098298	hoodie-cli	https://github.com/hoodiehq/hoodie-cli	0	2	0	2
10098483	ginzarb.github.io	https://github.com/ginzarb/ginzarb.github.io	0	1	0	1
10099643	pps-unitinfo	https://github.com/maselpopowo/pps-unitinfo	2	2	0	4
10100635	appsignal	https://github.com/appsignal/appsignal	1	0	0	1
10100882	contao-dependency-container	https://github.com/bit3/contao-dependency-container	1	0	0	1
10102280	snow	https://github.com/justcoin/snow	3	4	0	7
10103791	more_core_extensions	https://github.com/ManageIQ/more_core_extensions	0	1	0	1
10105283	generator-gumby	https://github.com/bauschan/generator-gumby	1	1	0	2
10107106	CV_Game	https://github.com/AlexSchwank/CV_Game	1	0	0	1
10109557	SugarTi	https://github.com/rborn/SugarTi	1	0	0	1
10119144	mcda-elicitation-web	https://github.com/drugis/mcda-elicitation-web	1	1	0	2
10121236	finvorkurs	https://github.com/renemeye/finvorkurs	4	0	0	4
10121529	codeclub-world	https://github.com/CodeClub/codeclub-world	1	0	0	1
10122776	GarfieltBlog-webpy	https://github.com/Garfielt/GarfieltBlog-webpy	0	2	0	2
10125319	kxmenu	https://github.com/kolyvan/kxmenu	1	0	0	1
10125962	ya_HUD	https://github.com/whayay/ya_HUD	1	0	0	1
10128845	cloverleaf	https://github.com/brandon-dacrib/cloverleaf	1	0	0	1
10128948	syndll2	https://github.com/synel/syndll2	1	0	0	1
10129051	webcl-demos	https://github.com/uebquite/webcl-demos	1	1	0	2
10129152	ligadopoliticos	https://github.com/ufjf-dcc/ligadopoliticos	1	0	0	1
10132546	richter	https://github.com/grechaw/richter	0	2	0	2
10133896	manta-compute-bin	https://github.com/joyent/manta-compute-bin	1	0	0	1
10144151	main	https://github.com/flower-platform/main	1	0	0	1
10154151	ungit	https://github.com/FredrikNoren/ungit	4	1	0	5
10158801	lua.vm.js	https://github.com/kripken/lua.vm.js	1	0	0	1
10164495	gif.js	https://github.com/jnordberg/gif.js	1	0	0	1
10165290	memomeme-issue-tracker	https://github.com/NStal/memomeme-issue-tracker	1	1	0	2
10166416	imud-issues	https://github.com/badhex/imud-issues	0	1	0	1
10167687	ForgeMultipart	https://github.com/Chicken-Bones/ForgeMultipart	0	3	0	3
10168456	android-training	https://github.com/vincent4j/android-training	1	1	0	2
10168972	gradle-plugin	https://github.com/appthwack/gradle-plugin	0	1	0	1
10174901	lead.js	https://github.com/also/lead.js	2	0	0	2
10182757	datagrid-bundle	https://github.com/thrace-project/datagrid-bundle	0	2	0	2
10183457	Angular-localStorage	https://github.com/agrublev/Angular-localStorage	1	0	0	1
10187082	pm2	https://github.com/Unitech/pm2	1	0	0	1
10188028	book	https://github.com/DiscoverMeteor/book	5	0	0	5
10189241	android-image-map	https://github.com/chenyoca/android-image-map	1	0	0	1
10190225	GIFter.js	https://github.com/leeoniya/GIFter.js	1	0	0	1
10197982	revilr	https://github.com/mbark/revilr	1	0	0	1
10198476	robovm-eclipse	https://github.com/robovm/robovm-eclipse	0	2	0	2
10198675	bridle	https://github.com/pearson-enabling-technologies/bridle	1	0	0	1
10199976	DnD4eCM	https://github.com/DarkSir23/DnD4eCM	1	0	0	1
10201170	Flaskmarks	https://github.com/plastboks/Flaskmarks	1	2	0	3
10202180	generator-marionette	https://github.com/mrichard/generator-marionette	1	0	0	1
10202583	minion-backend	https://github.com/mozilla/minion-backend	1	2	0	3
10204892	naics-api	https://github.com/louh/naics-api	1	2	0	3
10206225	ArcGIS-JS-with-AJAX-Control-Toolkit	https://github.com/WSDOT-GIS/ArcGIS-JS-with-AJAX-Control-Toolkit	0	1	0	1
10208089	DayZA3	https://github.com/Pwnoz0r/DayZA3	1	0	0	1
10208341	autolatex	https://github.com/gallandarakhneorg/autolatex	0	1	0	1
10212716	UWSchedule	https://github.com/hpxro7/UWSchedule	1	0	0	1
10214538	ion	https://github.com/koush/ion	0	1	0	1
10217071	tokyodistrict	https://github.com/kreaseed/tokyodistrict	1	0	0	1
10219106	mean	https://github.com/linnovate/mean	3	1	0	4
10219894	android_device_xiaomi_aries	https://github.com/mitwo-dev/android_device_xiaomi_aries	1	1	0	2
10220214	TomatoCart-v1	https://github.com/tomatocart/TomatoCart-v1	0	17	0	17
10226850	cwcon2014	https://github.com/siteslab/cwcon2014	0	1	0	1
10227793	TwitterBootstrapMvc	https://github.com/DmitryEfimenko/TwitterBootstrapMvc	5	6	1	12
10229934	Cubian	https://github.com/cubieplayer/Cubian	8	17	1	26
10230098	nodebob	https://github.com/geo8bit/nodebob	1	0	0	1
10232534	ExtAuth	https://github.com/sc0ttyd/ExtAuth	1	0	0	1
10235528	circulate	https://github.com/elizuck/circulate	4	4	1	9
10236384	try-wisp	https://github.com/Gozala/try-wisp	1	0	0	1
10239603	jquery.formance	https://github.com/omarshammas/jquery.formance	0	3	0	3
10250467	logging-server	https://github.com/popcornlog/logging-server	1	0	0	1
10253826	pickadate-rails	https://github.com/veracross/pickadate-rails	1	1	1	3
10254341	Cabin	https://github.com/CabinJS/Cabin	3	0	0	3
10254722	Candy	https://github.com/CabinJS/Candy	1	0	0	1
10255797	video.js-component	https://github.com/videojs/video.js-component	1	0	0	1
10256919	pystan	https://github.com/ariddell/pystan	1	0	0	1
10260539	SITracker	https://github.com/SidhNor/SITracker	1	0	0	1
10264130	django-localflavor	https://github.com/django/django-localflavor	1	1	0	2
10269178	ngUSD	https://github.com/forkch/ngUSD	1	0	0	1
10270128	requestify	https://github.com/ranm8/requestify	1	1	0	2
10270250	react	https://github.com/facebook/react	1	2	0	3
10271293	molarity	https://github.com/phetsims/molarity	0	1	0	1
10274443	Veranstaltungen	https://github.com/Berlin/Veranstaltungen	1	1	0	2
10280928	playstate	https://github.com/perandersson/playstate	7	0	0	7
10282042	haxe	https://github.com/HaxeFoundation/haxe	1	1	0	2
10283400	FadingActionBar	https://github.com/ManuelPeinado/FadingActionBar	1	0	0	1
10284315	OpenPeripheral	https://github.com/OpenMods/OpenPeripheral	1	0	0	1
10284986	Silex	https://github.com/SilexLab/Silex	1	1	0	2
10289991	LakeSISE	https://github.com/kornicameister/LakeSISE	2	0	0	2
10291390	Minestuck	https://github.com/mraof/Minestuck	0	1	0	1
10293065	cartoon	https://github.com/wangyixian/cartoon	0	2	0	2
10293578	EGO	https://github.com/krzysiekpiasecki/EGO	1	0	0	1
10293909	beacon	https://github.com/sanctityQ/beacon	4	6	0	10
10296128	AstroTools	https://github.com/AnotherOneAckap/AstroTools	0	0	1	1
10296149	News-Android-App	https://github.com/owncloud/News-Android-App	1	0	0	1
10296290	waterfall	https://github.com/Exodia/waterfall	1	0	0	1
10296683	CoK	https://github.com/DerGeras/CoK	0	1	0	1
10298075	equinox_clock	https://github.com/benwilliam/equinox_clock	0	1	0	1
10298623	XPrivacy	https://github.com/M66B/XPrivacy	2	2	0	4
10310404	dev_blog2	https://github.com/ScenK/dev_blog2	2	0	0	2
10312708	dpl	https://github.com/rkh/dpl	1	0	0	1
10312759	sqlalchemy-continuum	https://github.com/kvesteri/sqlalchemy-continuum	1	0	0	1
10314617	nedb-to-mongodb	https://github.com/louischatriot/nedb-to-mongodb	0	1	0	1
10319225	SynUtil	https://github.com/synel/SynUtil	1	0	0	1
10320817	pyramid	https://github.com/CommercialWebDevelopment/pyramid	0	2	0	2
10320928	generator-core	https://github.com/adobe-photoshop/generator-core	1	0	0	1
10321181	readium-viewer-demo1	https://github.com/readium/readium-viewer-demo1	1	0	0	1
10328167	meteor-reststop	https://github.com/gkoberger/meteor-reststop	1	0	0	1
10330484	unity-doc-script	https://github.com/unity3d-jp/unity-doc-script	12	998	0	1010
10332387	darkbounds	https://github.com/evyatron/darkbounds	0	2	0	2
10332565	enb-bemhtml	https://github.com/enb-make/enb-bemhtml	1	1	0	2
10335025	dota2quiz	https://github.com/tctimmeh/dota2quiz	1	1	0	2
10341239	thessc	https://github.com/matthiasbeyer/thessc	1	0	0	1
10341576	metridoc-job-core	https://github.com/metridoc/metridoc-job-core	0	4	0	4
10345080	DRMF	https://github.com/DRMF/DRMF	2	0	0	2
10348058	cyder	https://github.com/OSU-Net/cyder	1	0	0	1
10352774	iFrameAutoSize	https://github.com/rmlmedia/iFrameAutoSize	1	0	0	1
10354502	angular-jqm	https://github.com/angular-widgets/angular-jqm	2	0	0	2
10354555	expro-future-test	https://github.com/extensivepro/expro-future-test	3	1	0	4
10355851	aidkit	https://github.com/aidkit/aidkit	0	1	0	1
10357960	kvs	https://github.com/synrc/kvs	4	0	0	4
10360891	NHol	https://github.com/jack-pappas/NHol	1	0	0	1
10361168	rescue-me	https://github.com/DISCOOS/rescue-me	1	0	0	1
10363666	widgets	https://github.com/pinterest/widgets	1	0	0	1
10373529	go	https://github.com/ugorji/go	0	1	1	2
10374742	wardrobe	https://github.com/ericbarnes/wardrobe	1	1	0	2
10379410	blocktop	https://github.com/vj-team/blocktop	1	0	0	1
10379836	keyboard_convertor	https://github.com/torbjon/keyboard_convertor	1	0	0	1
10380342	node-http2	https://github.com/molnarg/node-http2	1	5	0	6
10385668	All-to-DPS	https://github.com/RPSource/All-to-DPS	1	1	0	2
10390210	uu-g	https://github.com/octplane/uu-g	1	0	0	1
10391073	edx-platform	https://github.com/edx/edx-platform	1	0	0	1
10394172	railto-issues	https://github.com/creativechannel/railto-issues	2	0	0	2
10395188	exercism.io	https://github.com/kytrinyx/exercism.io	3	2	0	5
10399273	mf-geoadmin3	https://github.com/geoadmin/mf-geoadmin3	11	3	0	14
10402988	TagMap	https://github.com/jacobandresen/TagMap	1	3	1	5
10403756	sprks	https://github.com/mapto/sprks	1	2	0	3
10405763	h2gglobe	https://github.com/h2gglobe/h2gglobe	1	3	1	5
10407719	pydy-viz	https://github.com/PythonDynamics/pydy-viz	1	0	0	1
10410764	AndroidSlidingUpPanel	https://github.com/umano/AndroidSlidingUpPanel	3	2	0	5
10411585	LeanMapper	https://github.com/Tharos/LeanMapper	1	0	0	1
10411713	xmpp-ftw-demo	https://github.com/lloydwatkin/xmpp-ftw-demo	2	1	0	3
10413203	oauth1-provider	https://github.com/tistaharahap/oauth1-provider	0	1	0	1
10415038	sculptor.github.io	https://github.com/sculptor/sculptor.github.io	2	0	0	2
10418430	angulartics	https://github.com/luisfarzati/angulartics	1	0	0	1
10419920	harserver	https://github.com/erpk/harserver	0	1	0	1
10420155	garrysmod-issues	https://github.com/Facepunch/garrysmod-issues	2	0	0	2
10421527	birdie	https://github.com/birdieapp/birdie	3	1	0	4
10433174	CodeBucket	https://github.com/thedillonb/CodeBucket	1	0	0	1
10439434	botto	https://github.com/mcaprari/botto	0	8	0	8
10440817	scarlet	https://github.com/scarletjs/scarlet	1	0	0	1
10441188	vgstation13	https://github.com/d3athrow/vgstation13	1	0	0	1
10441449	mhb	https://github.com/justiceamoh/mhb	1	1	0	2
10442564	fpm-maven-plugin	https://github.com/ajmfulcher/fpm-maven-plugin	1	0	0	1
10443295	FarmersMarketDirApp	https://github.com/chipbell4/FarmersMarketDirApp	2	0	0	2
10446111	WordMemorization	https://github.com/virusbb001/WordMemorization	0	1	0	1
10446618	remotely-observed-treatment	https://github.com/H0201030/remotely-observed-treatment	3	3	0	6
10447969	opencaesar3	https://github.com/dalerank/opencaesar3	0	1	0	1
10450313	logsearch-development-flow	https://github.com/cityindex/logsearch-development-flow	3	3	0	6
10453977	rtmpSnoop	https://github.com/andreafabrizi/rtmpSnoop	1	0	0	1
10459528	rogue_geonode	https://github.com/ROGUE-JCTD/rogue_geonode	0	1	0	1
10459797	myphillyrising	https://github.com/openplans/myphillyrising	0	1	0	1
10460258	generator-canjs	https://github.com/retro/generator-canjs	1	0	0	1
10462317	infrapix	https://github.com/Pioneer-Valley-Open-Science/infrapix	1	0	0	1
10463808	HDM-CartoCSS	https://github.com/hotosm/HDM-CartoCSS	2	0	0	2
10472950	mtirc	https://github.com/legoktm/mtirc	1	0	0	1
10475004	rs-serve	https://github.com/remotestorage/rs-serve	2	1	0	3
10476023	sklikapi	https://github.com/Sortivo/sklikapi	0	1	0	1
10478101	EmberCrossfilter	https://github.com/Wildhoney/EmberCrossfilter	0	1	0	1
10479386	unhangout	https://github.com/drewww/unhangout	2	1	0	3
10479791	pycon	https://github.com/caktus/pycon	4	3	0	7
10480910	ActionBar-PullToRefresh	https://github.com/chrisbanes/ActionBar-PullToRefresh	2	0	0	2
10483981	github	https://github.com/isaacs/github	1	0	0	1
10484346	oat	https://github.com/bwbecker/oat	1	0	0	1
10484418	angular-smoothscroll	https://github.com/arnaudbreton/angular-smoothscroll	0	1	0	1
10490767	metirium	https://github.com/jjccc/metirium	3	3	0	6
10491998	Net-Jenkins	https://github.com/cpanxaoc/Net-Jenkins	1	1	0	2
10492725	TeamsiteCalendarSync-Public	https://github.com/blueleader07/TeamsiteCalendarSync-Public	1	1	0	2
10493535	waterline-criteria	https://github.com/balderdashy/waterline-criteria	0	1	0	1
10506562	dogfeed	https://github.com/silverbucket/dogfeed	3	0	0	3
10510072	drone	https://github.com/registerguard/drone	1	0	0	1
10512134	tesi-sw	https://github.com/elehcim/tesi-sw	4	0	0	4
10512679	Backload	https://github.com/blackcity/Backload	1	1	0	2
10513956	the-mason-jar	https://github.com/the-mason-jar/the-mason-jar	1	1	0	2
10518659	co	https://github.com/visionmedia/co	1	1	0	2
10521266	parallax-doku	https://github.com/menatwork/parallax-doku	2	1	0	3
10524513	chaa-warburg	https://github.com/virgilio/chaa-warburg	0	2	0	2
10526808	test	https://github.com/truecode/test	16	0	0	16
10527485	issues	https://github.com/owdqa/issues	7	6	0	13
10527573	Libisnet-Omeka	https://github.com/libis/Libisnet-Omeka	0	3	0	3
10527600	Libisplus-Omeka	https://github.com/libis/Libisplus-Omeka	0	4	0	4
10530781	geoviqua-geonetwork-plugin	https://github.com/lushc/geoviqua-geonetwork-plugin	1	0	0	1
10533400	lcsh_suggest	https://github.com/awead/lcsh_suggest	0	1	0	1
10535034	MoPal	https://github.com/bsullins/MoPal	1	0	0	1
10536724	ib-csharp	https://github.com/krs43/ib-csharp	1	1	0	2
10537153	lct-android	https://github.com/mareuter/lct-android	2	2	0	4
10538430	OwlCarousel	https://github.com/OwlFonk/OwlCarousel	1	0	0	1
10539906	grupo4_ne3a_2013_1	https://github.com/RochaTSI/grupo4_ne3a_2013_1	0	1	0	1
10540001	ProjetoIntegradorLavaRapido	https://github.com/eduardogreco/ProjetoIntegradorLavaRapido	1	0	0	1
10540085	brackets-jsonlint	https://github.com/katsh/brackets-jsonlint	1	0	0	1
10546955	newsman	https://github.com/chengdujin/newsman	3	5	0	8
10547319	tracker	https://github.com/webix-hub/tracker	3	0	0	3
10555401	node-chromedriver	https://github.com/giggio/node-chromedriver	1	0	0	1
10555788	php-debugbar	https://github.com/maximebf/php-debugbar	0	1	0	1
10556194	codalab	https://github.com/codalab/codalab	3	0	0	3
10557569	WP-Job-Manager	https://github.com/mikejolley/WP-Job-Manager	1	1	0	2
10561271	durable_decorator	https://github.com/jumph4x/durable_decorator	1	1	0	2
10565551	attackvector	https://github.com/ksoona/attackvector	0	1	0	1
10566713	pickling	https://github.com/scala/pickling	1	1	0	2
10567197	dokku	https://github.com/progrium/dokku	3	2	0	5
10571283	parallel_test_tutorial	https://github.com/verdi327/parallel_test_tutorial	1	0	0	1
10575878	dockerui	https://github.com/crosbymichael/dockerui	1	0	0	1
10576408	ircbot	https://github.com/tjcsl/ircbot	0	1	0	1
10579297	Elm.tmLanguage	https://github.com/deadfoxygrandpa/Elm.tmLanguage	1	0	0	1
10579398	avalon	https://github.com/RubyLouvre/avalon	0	1	0	1
10582468	BiomesOPlenty	https://github.com/Glitchfiend/BiomesOPlenty	0	1	0	1
10592351	projetointegrado	https://github.com/tatodelaporte/projetointegrado	1	0	0	1
10594164	prism-break	https://github.com/nylira/prism-break	3	1	0	4
10594936	changeset	https://github.com/eugeneware/changeset	1	1	0	2
10599742	sling-explorer	https://github.com/jollyca/sling-explorer	0	1	0	1
10600144	Piccolo	https://github.com/opentable/Piccolo	2	2	0	4
10605933	givinggraph	https://github.com/dssg/givinggraph	0	3	0	3
10605987	metridoc-grails-core	https://github.com/metridoc/metridoc-grails-core	1	1	0	2
10607279	MyHostel	https://github.com/Hector21/MyHostel	4	5	0	9
10608695	elastic4s	https://github.com/sksamuel/elastic4s	1	0	0	1
10609497	teacher	https://github.com/ohmage/teacher	0	2	0	2
10609651	scg-web	https://github.com/deniskoronchik/scg-web	1	0	0	1
10613203	strangeioc	https://github.com/thirdmotion/strangeioc	0	1	0	1
10618426	boxen	https://github.com/quintel/boxen	1	0	0	1
10620970	processing-boilerplate	https://github.com/m90/processing-boilerplate	0	1	0	1
10625812	ODM2Sensor	https://github.com/UCHIC/ODM2Sensor	0	5	1	6
10628223	grunt-humans-txt	https://github.com/roughcoder/grunt-humans-txt	0	1	0	1
10631737	razor-server	https://github.com/puppetlabs/razor-server	2	1	0	3
10633708	rails_stdout_logging	https://github.com/heroku/rails_stdout_logging	0	1	1	2
10634962	amqp.node	https://github.com/squaremo/amqp.node	1	0	0	1
10639745	SWAP	https://github.com/CottageLabs/SWAP	1	1	0	2
10639751	papyrus-war	https://github.com/susu/papyrus-war	1	0	0	1
10642495	newsplus	https://github.com/noinnion/newsplus	1	6	0	7
10642708	motoman	https://github.com/ros-industrial/motoman	0	1	0	1
10644477	freenas-extra	https://github.com/bionoren/freenas-extra	1	0	0	1
10645170	tregmine	https://github.com/EmilHernvall/tregmine	1	0	0	1
10646552	gaebusiness	https://github.com/renzon/gaebusiness	1	1	0	2
10649374	ecto	https://github.com/elixir-lang/ecto	0	4	0	4
10651005	cocotb	https://github.com/potentialventures/cocotb	1	1	0	2
10662898	samp-public	https://github.com/gtasarp/samp-public	1	0	0	1
10669570	SimpleAuth	https://github.com/shoghicp/SimpleAuth	0	1	0	1
10670826	snake	https://github.com/javakat/snake	2	7	0	9
10673199	bids	https://github.com/eDiper/bids	1	2	0	3
10675395	framework	https://github.com/sccherry/framework	1	6	0	7
10676833	intellij-xquery	https://github.com/ligasgr/intellij-xquery	0	1	0	1
10680107	LaptopsandTickets-1-1	https://github.com/pennmanor/LaptopsandTickets-1-1	1	1	0	2
10684514	cards	https://github.com/netxph/cards	4	1	0	5
10686941	tracker	https://github.com/turnkeylinux/tracker	0	2	0	2
10689273	sm	https://github.com/xapi-project/sm	1	0	0	1
10693201	wvus.uikit	https://github.com/wvus-ibu/wvus.uikit	2	2	0	4
10696093	QTCIDE	https://github.com/NucleaPeon/QTCIDE	1	0	0	1
10696293	phantom_omni	https://github.com/danepowell/phantom_omni	0	1	0	1
10697680	mod_authn_persona	https://github.com/mozilla/mod_authn_persona	1	0	0	1
10698703	coldsweat	https://github.com/passiomatic/coldsweat	1	0	0	1
10703518	kiss3d	https://github.com/sebcrozet/kiss3d	0	1	0	1
10705327	rgsoc-teams	https://github.com/rails-girls-summer-of-code/rgsoc-teams	0	1	0	1
10709912	quizy	https://github.com/jam231/quizy	5	4	0	9
10712489	ReactiveViewModel	https://github.com/ReactiveCocoa/ReactiveViewModel	1	1	0	2
10717112	shipyard	https://github.com/ehazlett/shipyard	1	1	0	2
10719126	crowdinvestre-build-spec	https://github.com/henrytao/crowdinvestre-build-spec	1	0	0	1
10720578	MOPCON_iOSApps	https://github.com/MOPCON/MOPCON_iOSApps	5	1	0	6
10723611	atelierfemkeboschker	https://github.com/remkoboschker/atelierfemkeboschker	0	1	0	1
10723664	livestyle-sublime	https://github.com/emmetio/livestyle-sublime	2	0	0	2
10726093	mev	https://github.com/dfci-cccb/mev	1	3	0	4
10727068	bacula_configuration	https://github.com/BrianGallew/bacula_configuration	1	0	0	1
10730363	PKMDS-G5	https://github.com/codemonkey85/PKMDS-G5	6	5	0	11
10734030	fae	https://github.com/hanshoglund/fae	7	3	0	10
10735200	CinC	https://github.com/Bronsa/CinC	1	0	0	1
10735453	CMISContentProvider	https://github.com/rajaths589/CMISContentProvider	1	1	0	2
10736620	bintray-sbt	https://github.com/softprops/bintray-sbt	1	1	0	2
10741874	dfrpg-toonstore	https://github.com/stevenvergenz/dfrpg-toonstore	0	1	0	1
10743874	umobile-app-phonegap	https://github.com/snschnei/umobile-app-phonegap	9	0	0	9
10744131	FubuTransportation	https://github.com/DarthFubuMVC/FubuTransportation	1	3	0	4
10744270	pycapnp	https://github.com/jparyani/pycapnp	1	0	0	1
10745441	ducalifornia	https://github.com/ivanrodriguez5/ducalifornia	1	0	0	1
10747908	geocoder	https://github.com/rtablada/geocoder	1	0	0	1
10748336	bluesky-project	https://github.com/luversof/bluesky-project	1	0	0	1
10750276	maximum-awesome	https://github.com/square/maximum-awesome	1	3	0	4
10752958	afch	https://github.com/WPAFC/afch	1	2	2	5
10754100	TeamCanjica	https://github.com/TeamCanjica/TeamCanjica	0	1	0	1
10755256	iron-router	https://github.com/EventedMind/iron-router	2	2	0	4
10757753	panda-cms	https://github.com/himmel22/panda-cms	0	4	0	4
10758754	pessimize	https://github.com/joonty/pessimize	1	0	0	1
10759860	dradispro-tracker	https://github.com/securityroots/dradispro-tracker	4	1	0	5
10761190	osync	https://github.com/deajan/osync	1	0	0	1
10766330	prototyp1	https://github.com/jepetko/prototyp1	3	0	0	3
10767602	sysadmin	https://github.com/CottageLabs/sysadmin	0	1	0	1
10768398	chcemvediet	https://github.com/mmmaly/chcemvediet	1	0	0	1
10770409	LEDITA	https://github.com/arpetti/LEDITA	2	1	0	3
10772469	chocolateypackages	https://github.com/AnthonyMastrean/chocolateypackages	1	0	0	1
10773038	orcamento.inesc.org.br	https://github.com/okfn-brasil/orcamento.inesc.org.br	1	0	0	1
10774342	zwd	https://github.com/oscarholmedo/zwd	0	1	0	1
10775999	newrelic-plugin-agent	https://github.com/MeetMe/newrelic-plugin-agent	2	1	0	3
10777373	atdis	https://github.com/openaustralia/atdis	6	0	0	6
10777853	agora	https://github.com/PuerkitoBio/agora	0	1	0	1
10782380	soy	https://github.com/soystack/soy	0	2	0	2
10789390	PyF5	https://github.com/WeijuNB/PyF5	1	0	0	1
10790175	rust-issues	https://github.com/Facepunch/rust-issues	7	4	0	11
10794310	bjc-r	https://github.com/beautyjoy/bjc-r	1	0	0	1
10795882	hdevtools	https://github.com/bennofs/hdevtools	1	0	0	1
10796405	moodle-block_quickset	https://github.com/bobpuffer/moodle-block_quickset	1	0	0	1
10798054	everysport-java-sdk	https://github.com/menmo/everysport-java-sdk	0	0	1	1
10800667	loggregator	https://github.com/cloudfoundry/loggregator	1	0	0	1
10801827	PortableRechargerDist	https://github.com/Aroma1997/PortableRechargerDist	1	0	0	1
10803374	obento	https://github.com/gwu-libraries/obento	1	0	0	1
10804395	newrelic-perfmon-plugin	https://github.com/nickfloyd/newrelic-perfmon-plugin	1	1	1	3
10805064	ld-bikecount	https://github.com/hampelm/ld-bikecount	3	0	0	3
10808320	waffle.io	https://github.com/waffleio/waffle.io	1	0	0	1
10809665	vmob-ios-sdk	https://github.com/vmob/vmob-ios-sdk	1	0	0	1
10810103	airport_plus	https://github.com/markmossberg/airport_plus	0	2	0	2
10810592	ember-cpm	https://github.com/jamesarosen/ember-cpm	0	1	0	1
10810645	hu	https://github.com/skylink/hu	0	2	0	2
10816208	kibitsu	https://github.com/hayashima/kibitsu	1	0	0	1
10816433	offiria	https://github.com/offiria/offiria	7	6	0	13
10816539	aDNA-phenotype	https://github.com/Skalbaggsmos/aDNA-phenotype	1	0	0	1
10818185	dalaran-wow	https://github.com/dalaranwow/dalaran-wow	2	0	0	2
10818678	ro-gentoo-book	https://github.com/sidro/ro-gentoo-book	0	1	0	1
10818918	Magento-Module-Atos	https://github.com/quadra-informatique/Magento-Module-Atos	0	1	0	1
10822601	stockade	https://github.com/cloudkeep/stockade	1	0	0	1
10823307	Hubot-Scripts-perlstudy	https://github.com/newbcode/Hubot-Scripts-perlstudy	1	0	0	1
10825463	MHST2013-14	https://github.com/ngocchung75/MHST2013-14	12	0	0	12
10828844	documentation	https://github.com/apiphany/documentation	1	0	0	1
10828921	genie	https://github.com/Netflix/genie	0	1	0	1
10829259	analytics-l4	https://github.com/thujohn/analytics-l4	1	0	0	1
10831493	Stopwatch	https://github.com/Smark11/Stopwatch	4	3	0	7
10834552	Bootstrap-Confirmation	https://github.com/ethaizone/Bootstrap-Confirmation	1	0	0	1
10834848	edusec-college-management-system	https://github.com/EduSec/edusec-college-management-system	0	1	0	1
10841814	geoviqua-inspire-tutorial	https://github.com/lushc/geoviqua-inspire-tutorial	1	0	0	1
10842260	newrelic-ng	https://github.com/flinc-chef/newrelic-ng	2	0	0	2
10842332	Weyland	https://github.com/BlueSpire/Weyland	1	0	0	1
10842345	cupcake	https://github.com/Kunstmaan/cupcake	0	5	0	5
10849479	acmeair-netflix	https://github.com/aspyker/acmeair-netflix	0	1	0	1
10850629	opencart-ce	https://github.com/opencart-ce/opencart-ce	0	1	0	1
10850960	peep	https://github.com/erikrose/peep	1	0	0	1
10851746	bootstrap-tree	https://github.com/jhfrench/bootstrap-tree	0	1	0	1
10852497	feedback_me	https://github.com/vedmack/feedback_me	0	1	0	1
10852635	lemonade	https://github.com/dope/lemonade	1	0	0	1
10858210	dirac	https://github.com/jrf0110/dirac	1	0	0	1
10858989	dynamic-image	https://github.com/tgjones/dynamic-image	1	0	0	1
10859715	cinch-evalso	https://github.com/sparkhom/cinch-evalso	1	0	0	1
10859801	decors	https://github.com/tangmi/decors	2	0	0	2
10860152	tachikoma	https://github.com/sanemat/tachikoma	1	0	0	1
10866618	MSSimpleGauge	https://github.com/sabymike/MSSimpleGauge	2	0	0	2
10867339	mps-tables	https://github.com/slisson/mps-tables	1	3	0	4
10871178	NappUI	https://github.com/viezel/NappUI	4	0	0	4
10875153	generator-poet	https://github.com/akshayp/generator-poet	1	0	0	1
10888103	backgrid-paginator	https://github.com/wyuenho/backgrid-paginator	1	0	0	1
10893201	silverstripe-fluent	https://github.com/tractorcow/silverstripe-fluent	1	1	0	2
10893351	trendie	https://github.com/okize/trendie	2	1	0	3
10893933	site	https://github.com/brwebmaster/site	5	3	0	8
10895036	seajs-combo	https://github.com/seajs/seajs-combo	1	0	0	1
10898034	mss-android	https://github.com/galievruslan/mss-android	5	6	0	11
10898151	crunch	https://github.com/arecarn/crunch	3	2	0	5
10901119	Ochsner	https://github.com/gnowland/Ochsner	1	0	0	1
10906288	go-nike-ghr	https://github.com/praekelt/go-nike-ghr	1	0	0	1
10906415	libcomps	https://github.com/midnightercz/libcomps	0	1	0	1
10908716	DoodleTee	https://github.com/xieyajie/DoodleTee	0	7	0	7
10908960	meteor-animation	https://github.com/Rebolon/meteor-animation	1	0	0	1
10911820	Dispersion_Tracker	https://github.com/sdyessdev/Dispersion_Tracker	0	3	0	3
10912639	ThePassion	https://github.com/mrcancer91/ThePassion	0	1	0	1
10915984	xenadmin	https://github.com/xenserver/xenadmin	1	0	0	1
10917560	FED2	https://github.com/CMDA/FED2	1	0	0	1
10917677	pycoin	https://github.com/richardkiss/pycoin	2	2	0	4
10919869	rfm12b-linux	https://github.com/gkaindl/rfm12b-linux	1	0	0	1
10920791	cp_taxmaxx	https://github.com/thecookiefactory/cp_taxmaxx	0	3	0	3
10922201	tasks	https://github.com/Code-for-Miami/tasks	0	1	0	1
10923738	oh-greenhouse	https://github.com/openhatch/oh-greenhouse	3	0	0	3
10925118	SVBE-Cloud-Tools	https://github.com/doctorfork/SVBE-Cloud-Tools	4	0	0	4
10926279	padherder-issues	https://github.com/madcowfred/padherder-issues	1	0	0	1
10926931	code-for-miami.github.io	https://github.com/Code-for-Miami/code-for-miami.github.io	1	0	0	1
10929447	DSVR	https://github.com/dboyd13/DSVR	1	0	0	1
10934806	webim-plugin-service	https://github.com/webim/webim-plugin-service	1	9	0	10
10942462	magento_integration	https://github.com/openlabs/magento_integration	1	0	0	1
10942724	bind-filter	https://github.com/jillix/bind-filter	0	1	0	1
10946861	capybara-accessible	https://github.com/Casecommons/capybara-accessible	1	0	0	1
10947678	conf-registration-api	https://github.com/CruGlobal/conf-registration-api	2	1	0	3
10948481	hiera-eyaml	https://github.com/TomPoulton/hiera-eyaml	1	0	0	1
10949184	ankieter	https://github.com/krzyk87/ankieter	0	2	0	2
10950336	website	https://github.com/HeadspringLabs/website	0	2	0	2
10952381	cwac-camera	https://github.com/commonsguy/cwac-camera	1	0	1	2
10959871	dd2d_Matryoshka	https://github.com/adhishm/dd2d_Matryoshka	0	1	0	1
10959882	cookbook-service_factory	https://github.com/org-binbab/cookbook-service_factory	1	0	0	1
10963937	semantischeOperabilitaet2013	https://github.com/gillesB/semantischeOperabilitaet2013	1	6	0	7
10967750	pdftables	https://github.com/scraperwiki/pdftables	2	1	0	3
10968472	p5-mop-redux	https://github.com/stevan/p5-mop-redux	0	1	0	1
10969551	cmssw	https://github.com/cms-sw/cmssw	0	1	0	1
10972656	usaha_committee	https://github.com/tracefirst/usaha_committee	1	1	0	2
10974542	simpleTooltip	https://github.com/BR0kEN-/simpleTooltip	1	2	0	3
10974951	learnxinyminutes-docs	https://github.com/adambard/learnxinyminutes-docs	1	0	0	1
10976257	meddler	https://github.com/russross/meddler	1	1	0	2
10977130	cinnamon-feeds-applet	https://github.com/jonbrett/cinnamon-feeds-applet	2	0	0	2
10978577	pencil	https://github.com/pencil2d/pencil	1	0	0	1
10979955	starburst	https://github.com/Nebelhom/starburst	3	2	0	5
10984397	deal	https://github.com/Inaimathi/deal	6	3	0	9
10994711	cron	https://github.com/liebig/cron	0	2	0	2
10997054	BitMailServer	https://github.com/AyrA/BitMailServer	1	0	0	1
10997321	sphinxsearch	https://github.com/fheyer/sphinxsearch	1	0	0	1
10998926	issues	https://github.com/ucfalmouth/issues	3	0	0	3
11001618	course-site	https://github.com/dmhurley/course-site	1	2	0	3
11006891	conf-registration-web	https://github.com/CruGlobal/conf-registration-web	0	1	0	1
11007051	Automatika	https://github.com/tsalmon/Automatika	2	1	0	3
11007313	Babylon.js	https://github.com/BabylonJS/Babylon.js	1	2	0	3
11011419	templ	https://github.com/carlos8f/templ	1	1	0	2
11019260	meteor-momentjs	https://github.com/crapthings/meteor-momentjs	1	0	0	1
11021585	testsuites	https://github.com/sysapps/testsuites	1	0	0	1
11026449	nodes	https://github.com/lelylan/nodes	1	0	0	1
11028766	Cobalt	https://github.com/mnestis/Cobalt	5	3	0	8
11038157	soundcast	https://github.com/PugetSoundRegionalCouncil/soundcast	2	3	0	5
11039740	ECE382	https://github.com/toddbranch/ECE382	1	0	0	1
11040775	backbone.giraffe	https://github.com/barc/backbone.giraffe	0	2	0	2
11042851	subte	https://github.com/MongoDBPeru/subte	2	2	0	4
11048121	opencv	https://github.com/iwazer/opencv	1	0	0	1
11054424	acid-state	https://github.com/acid-state/acid-state	0	2	0	2
11054453	bootstrap-social	https://github.com/lipis/bootstrap-social	1	0	0	1
11055207	Safari-Push-Notifications	https://github.com/connorlacombe/Safari-Push-Notifications	1	1	0	2
11056034	vim-holylight	https://github.com/Dinduks/vim-holylight	1	0	0	1
11061085	XIVPads-LodestoneAPI	https://github.com/viion/XIVPads-LodestoneAPI	2	0	0	2
11064434	openroad	https://github.com/Openroadvietnam/openroad	2	4	0	6
11064723	linkadex	https://github.com/msrose/linkadex	1	1	0	2
11070374	laravel-backup	https://github.com/schickling/laravel-backup	0	2	0	2
11070903	scalania	https://github.com/jaceklaskowski/scalania	1	0	0	1
11075527	vim-airline	https://github.com/bling/vim-airline	3	3	1	7
11075918	FeedbinNotifier	https://github.com/kmikael/FeedbinNotifier	1	0	0	1
11080240	ember-app-kit	https://github.com/stefanpenner/ember-app-kit	0	1	0	1
11081909	forgottenserver	https://github.com/otland/forgottenserver	0	1	0	1
11085348	matsue-team	https://github.com/railsgirls-jp/matsue-team	1	0	0	1
11086288	unix_service_mock_daemon	https://github.com/org-binbab/unix_service_mock_daemon	1	0	0	1
11088250	graphlab	https://github.com/graphlab-code/graphlab	0	1	0	1
11094149	OverMapped	https://github.com/Wolvereness/OverMapped	5	3	0	8
11094567	node-cassandra-cql	https://github.com/jorgebay/node-cassandra-cql	0	1	0	1
11101054	ember-couchdb-kit	https://github.com/roundscope/ember-couchdb-kit	0	2	0	2
11110385	cvxpy	https://github.com/cvxgrp/cvxpy	1	0	0	1
11112595	Learning	https://github.com/Spica99/Learning	1	0	0	1
11115594	edp-webserver	https://github.com/ecomfe/edp-webserver	1	1	0	2
11116372	keystone	https://github.com/JedWatson/keystone	1	4	0	5
11117485	tempRock_a_ling	https://github.com/glantucan/tempRock_a_ling	1	0	0	1
11119602	yuntang-platform	https://github.com/itang/yuntang-platform	1	0	0	1
11120888	osu-api	https://github.com/peppy/osu-api	1	0	0	1
11121291	objd-idea-plugin	https://github.com/antonzherdev/objd-idea-plugin	0	4	0	4
11123774	inanity	https://github.com/quyse/inanity	0	1	0	1
11124059	Chattro	https://github.com/FitroApp/Chattro	3	5	0	8
11124357	event_girl	https://github.com/Absolventa/event_girl	1	1	1	3
11125394	Bugtracker-Infinium-4.3.4	https://github.com/RoDNet/Bugtracker-Infinium-4.3.4	14	24	0	38
11130076	EWB-Morocco	https://github.com/akalicki/EWB-Morocco	0	2	0	2
11131446	php-application-core-twig-integration	https://github.com/zyberWare/php-application-core-twig-integration	3	0	0	3
11131493	fixmystreet-mobile	https://github.com/mysociety/fixmystreet-mobile	0	1	0	1
11131760	php-application-core	https://github.com/zyberWare/php-application-core	2	0	0	2
11133918	Metro	https://github.com/anisbet/Metro	1	1	0	2
11137392	bizfriendly-web	https://github.com/codeforamerica/bizfriendly-web	2	0	0	2
11139680	libzerocoin	https://github.com/Zerocoin/libzerocoin	1	0	0	1
11140459	parceler	https://github.com/johncarl81/parceler	1	0	0	1
11145835	ByronleeStyle	https://github.com/Byronlee/ByronleeStyle	5	0	0	5
11149317	php-application-core-demo	https://github.com/zyberWare/php-application-core-demo	3	0	0	3
11151396	eliom-base-app	https://github.com/ocsigen/eliom-base-app	1	1	0	2
11152786	helpdesk	https://github.com/itdoors/helpdesk	0	1	1	2
11153610	mod-lang-clojure	https://github.com/vert-x/mod-lang-clojure	1	0	0	1
11153660	ios-makefile	https://github.com/lexrus/ios-makefile	1	0	0	1
11153867	taxon-tool	https://github.com/SIB-Colombia/taxon-tool	1	0	0	1
11154385	puppet-varnish	https://github.com/netmanagers/puppet-varnish	0	1	0	1
11156601	CONCOCT	https://github.com/BinPro/CONCOCT	1	2	0	3
11157303	gitforsoftimage	https://github.com/csaez/gitforsoftimage	1	0	0	1
11158196	coge	https://github.com/LyonsLab/coge	1	0	0	1
11159552	OpenStudio	https://github.com/NREL/OpenStudio	0	1	0	1
11159896	real-time-web-chat	https://github.com/simonewebdesign/real-time-web-chat	1	0	0	1
11162460	numfocus.org	https://github.com/numfocus/numfocus.org	10	3	0	13
11164583	blog4app	https://github.com/zivee/blog4app	1	0	0	1
11164718	MozStumbler	https://github.com/dougt/MozStumbler	1	0	0	1
11170508	instant.ariatemplates.com	https://github.com/ariatemplates/instant.ariatemplates.com	0	1	0	1
11171599	ckeditor-track-changes	https://github.com/loopindex/ckeditor-track-changes	1	0	0	1
11173379	meduseld	https://github.com/agenceepsilon/meduseld	2	2	0	4
11177980	genometools	https://github.com/genometools/genometools	0	2	0	2
11179122	A	https://github.com/Tornaldo/A	1	0	0	1
11180687	hugo	https://github.com/spf13/hugo	0	1	0	1
11185549	joystick_integrator	https://github.com/a-price/joystick_integrator	1	0	0	1
11187703	bower-angular-unstable	https://github.com/euskadi31/bower-angular-unstable	1	0	0	1
11188760	navgoco	https://github.com/tefra/navgoco	1	0	0	1
11188943	test-pages-dl-2	https://github.com/roberts-sandbox/test-pages-dl-2	2	0	0	2
11189143	luckypots	https://github.com/elizahyde/luckypots	3	0	0	3
11191973	JavaLib	https://github.com/PunchlineGames/JavaLib	0	0	1	1
11195110	malgraph4	https://github.com/rr-/malgraph4	1	0	0	1
11200367	linux_media	https://github.com/ljalves/linux_media	1	0	0	1
11205905	cogumelo	https://github.com/Innoto/cogumelo	3	0	0	3
11205952	lmc	https://github.com/jojoob/lmc	2	2	0	4
11208585	task-force-arma-3-radio	https://github.com/michail-nikolaev/task-force-arma-3-radio	3	5	0	8
11213384	go-etcd	https://github.com/coreos/go-etcd	1	0	0	1
11215149	SuckPlatformCracker	https://github.com/zengyun-programmer/SuckPlatformCracker	2	0	0	2
11222714	QuestionsProject	https://github.com/GodPlaysChess/QuestionsProject	0	1	0	1
11225014	etcd	https://github.com/coreos/etcd	1	0	0	1
11225980	MCPC-Plus	https://github.com/MinecraftPortCentral/MCPC-Plus	4	0	0	4
11231928	SoccerSim	https://github.com/xlcteam/SoccerSim	0	1	0	1
11232995	djattendance	https://github.com/attendanceproject/djattendance	2	2	0	4
11238265	hmmm	https://github.com/schuel/hmmm	0	1	0	1
11238862	T3	https://github.com/mck-/T3	2	0	0	2
11239518	pdn04	https://github.com/lukhio/pdn04	6	0	0	6
11240857	grunt-hash-data	https://github.com/creativ/grunt-hash-data	1	0	0	1
11240958	argparseui	https://github.com/shimpe/argparseui	1	1	0	2
11240975	interview	https://github.com/kidexp/interview	0	2	0	2
11246675	auraxiscontrolcenter	https://github.com/cesarramirez/auraxiscontrolcenter	1	0	0	1
11253131	commonWidget	https://github.com/QzoneTouch/commonWidget	1	0	0	1
11254191	x-picture	https://github.com/uniqname/x-picture	1	0	0	1
11256035	unrest	https://github.com/dmitriid/unrest	3	0	0	3
11256534	sib-dataportal	https://github.com/sibbr/sib-dataportal	0	1	0	1
11256638	bikeshare	https://github.com/dssg/bikeshare	1	0	0	1
11258223	autocmdr	https://github.com/Hypercubed/autocmdr	0	5	0	5
11258552	mqtt	https://github.com/lelylan/mqtt	1	0	0	1
11260454	ergoemacs-mode	https://github.com/ergoemacs/ergoemacs-mode	2	0	0	2
11261480	cuwo	https://github.com/matpow2/cuwo	0	1	0	1
11262222	online-collections-db	https://github.com/timvenn20183/online-collections-db	2	3	0	5
11262602	python-driver	https://github.com/datastax/python-driver	2	0	0	2
11267509	glide	https://github.com/bumptech/glide	1	0	0	1
11273031	vulcan	https://github.com/mailgun/vulcan	1	0	0	1
11273069	onebox	https://github.com/dysania/onebox	2	1	0	3
11276105	server	https://github.com/osiam/server	2	0	0	2
11276417	Android-Adhoc	https://github.com/ukinau/Android-Adhoc	0	1	0	1
11279520	LHF-Tracking-System	https://github.com/cchow32/LHF-Tracking-System	2	0	1	3
11286868	app-tutorial	https://github.com/pedestal/app-tutorial	0	1	0	1
11291691	wkhtml2pdf	https://github.com/NitMedia/wkhtml2pdf	1	1	0	2
11292011	OpenMEE	https://github.com/gdietz/OpenMEE	1	1	0	2
11292535	Nebula	https://github.com/hakuch/Nebula	4	0	0	4
11293880	swift-private-cloud	https://github.com/rcbops-cookbooks/swift-private-cloud	2	2	0	4
11296042	legistar-scrape	https://github.com/opengovernment/legistar-scrape	0	1	0	1
11297953	openshift-android	https://github.com/sabre1041/openshift-android	1	0	0	1
11297967	curser	https://github.com/citricsquid/curser	1	0	0	1
11299300	Dota-2	https://github.com/ValveSoftware/Dota-2	3	3	0	6
11301702	loaf.js	https://github.com/classdojo/loaf.js	1	1	0	2
11305160	Feedly-Notifier-Firefox	https://github.com/olsh/Feedly-Notifier-Firefox	1	0	0	1
11306853	com.hp.sv	https://github.com/SVVirtualBuilder/com.hp.sv	1	0	0	1
11308816	EchoPet	https://github.com/DSH105/EchoPet	1	0	0	1
11312786	wikibots	https://github.com/benapetr/wikibots	1	0	0	1
11313110	app	https://github.com/purushothamc/app	1	0	0	1
11314771	auto_ticket_add	https://github.com/gosyujin/auto_ticket_add	1	0	0	1
11317319	mqttitude	https://github.com/binarybucks/mqttitude	3	1	0	4
11318084	grunt-contrib-ftpush	https://github.com/inossidabile/grunt-contrib-ftpush	1	0	0	1
11324641	triageProject	https://github.com/BMKEG/triageProject	2	0	0	2
11324859	brief	https://github.com/ancestorak/brief	3	0	0	3
11328479	PurdueSIGGD.github.io	https://github.com/PurdueSIGGD/PurdueSIGGD.github.io	1	1	0	2
11329386	Pinboard-Context-Menu	https://github.com/kafene/Pinboard-Context-Menu	0	1	0	1
11337726	sublime-monokai-extended	https://github.com/jonschlinkert/sublime-monokai-extended	2	0	0	2
11340833	squishy-pants	https://github.com/SimonRichardson/squishy-pants	0	2	0	2
11343183	tisa-map	https://github.com/g0v/tisa-map	3	2	0	5
11344750	systemsgenetics	https://github.com/molgenis/systemsgenetics	1	1	0	2
11348555	neo_cc	https://github.com/maxdemarzi/neo_cc	1	1	0	2
11353159	generator-spring	https://github.com/countableSet/generator-spring	2	0	0	2
11355724	pretty-pic-storer	https://github.com/zhaozhiming/pretty-pic-storer	2	1	0	3
11356952	consensus	https://github.com/davidtlee/consensus	4	3	0	7
11357692	ui-test	https://github.com/einherjer-uy/ui-test	1	2	0	3
11364102	etcutils	https://github.com/dacamp/etcutils	1	0	0	1
11364812	oandbackup	https://github.com/jensstein/oandbackup	1	0	0	1
11370471	omd	https://github.com/pw374/omd	0	1	0	1
11370804	mineos	https://github.com/hexparrot/mineos	1	0	0	1
11371048	slycat	https://github.com/sandialabs/slycat	3	2	0	5
11371241	baxter_common	https://github.com/RethinkRobotics/baxter_common	1	0	0	1
11375137	play-module-twitter	https://github.com/mfizz-inc/play-module-twitter	1	0	0	1
11378642	accessibility-developer-tools	https://github.com/GoogleChrome/accessibility-developer-tools	1	3	0	4
11378647	wattdepot	https://github.com/csdl/wattdepot	1	0	0	1
11380073	luacppinterface	https://github.com/davidsiaw/luacppinterface	1	0	0	1
11380930	MediaCrush	https://github.com/MediaCrush/MediaCrush	5	1	0	6
11385196	domain-search-system	https://github.com/mkroli/domain-search-system	1	0	0	1
11385681	Librarica	https://github.com/cuter44/Librarica	1	0	0	1
11390181	protector-cancan	https://github.com/inossidabile/protector-cancan	1	0	0	1
11390948	twangry	https://github.com/g0v/twangry	1	0	0	1
11391005	gindpubs-frameworks	https://github.com/fcontreras/gindpubs-frameworks	1	0	0	1
11398075	php-snapchat	https://github.com/dstelljes/php-snapchat	0	1	0	1
11399806	viff	https://github.com/winsonwq/viff	0	1	0	1
11402010	DbDepPopulator	https://github.com/aneeshpu/DbDepPopulator	3	1	0	4
11404772	gridtype	https://github.com/gridtype/gridtype	3	2	0	5
11404775	linner	https://github.com/SaitoWu/linner	1	0	0	1
11412615	openmm-cmd	https://github.com/rmcgibbo/openmm-cmd	0	1	0	1
11416194	nyanga	https://github.com/richardhundt/nyanga	1	0	0	1
11418573	website	https://github.com/destinygg/website	1	0	0	1
11419230	ingress-apk-mod	https://github.com/Ingress-apk-mod/ingress-apk-mod	2	0	0	2
11420093	cryptos	https://github.com/hak8or/cryptos	1	5	0	6
11420540	apex-live-validation	https://github.com/nbuytaert1/apex-live-validation	2	0	0	2
11421101	detective.io	https://github.com/jplusplus/detective.io	1	2	0	3
11421215	contacts	https://github.com/grytsenko/contacts	1	0	0	1
11426263	rwdfruhoh.ookb.co	https://github.com/bjornmeansbear/rwdfruhoh.ookb.co	5	0	0	5
11428842	b-datum-linux	https://github.com/b-datum/b-datum-linux	2	0	0	2
11434134	vue2owl	https://github.com/phenoscape/vue2owl	1	0	0	1
11435824	nico_cui	https://github.com/gosyujin/nico_cui	2	0	0	2
11439267	ux-feed	https://github.com/cmegown/ux-feed	1	0	0	1
11443656	chrome-online-radio	https://github.com/Anonym-tsk/chrome-online-radio	0	1	0	1
11446601	mod-webui	https://github.com/shinken-monitoring/mod-webui	0	1	0	1
11448672	dexter	https://github.com/davidbrazdil/dexter	0	1	0	1
11451018	Parse-CPAN-Meta	https://github.com/Perl-Toolchain-Gang/Parse-CPAN-Meta	1	0	0	1
11452676	nghttp2	https://github.com/tatsuhiro-t/nghttp2	0	1	0	1
11454256	planning	https://github.com/ndlib/planning	3	6	0	9
11456440	drinkIt	https://github.com/Crabar/drinkIt	5	1	0	6
11457945	clingify	https://github.com/theroux/clingify	1	0	0	1
11460775	watchmen	https://github.com/brightcove/watchmen	1	0	0	1
11461564	openx-source	https://github.com/openx/openx-source	2	1	0	3
11463269	ssat	https://github.com/mfrederickson/ssat	1	0	0	1
11463944	micro_erp	https://github.com/erikhenrique/micro_erp	9	0	0	9
11470363	appthwack-java	https://github.com/appthwack/appthwack-java	1	0	0	1
11470536	funcunit.js	https://github.com/bitovi/funcunit.js	1	0	0	1
11475816	fluent-plugin-geoip	https://github.com/y-ken/fluent-plugin-geoip	1	1	0	2
11476546	nansat	https://github.com/nansencenter/nansat	1	0	0	1
11480705	triqs	https://github.com/TRIQS/triqs	2	0	0	2
11481753	yana-server	https://github.com/ldleman/yana-server	1	2	0	3
11481891	showtime	https://github.com/alphagov/showtime	0	1	0	1
11484758	DbQuery	https://github.com/bingzer/DbQuery	1	0	0	1
11485353	hepunion	https://github.com/disdi/hepunion	2	0	0	2
11486407	quest	https://github.com/hozano/quest	0	1	0	1
11486451	apidoc	https://github.com/SolutionsCloud/apidoc	2	0	0	2
11486498	sbt-builds-for-ide	https://github.com/typesafehub/sbt-builds-for-ide	0	1	0	1
11490305	jsl	https://github.com/chrisdickinson/jsl	1	4	0	5
11490462	better_spree_paypal_express	https://github.com/radar/better_spree_paypal_express	0	0	1	1
11491798	officeassassin	https://github.com/jonsabados/officeassassin	0	1	0	1
11492795	Glydar	https://github.com/Glydar/Glydar	1	0	0	1
11495248	StenoTutor	https://github.com/caru/StenoTutor	1	0	0	1
11497856	clsync	https://github.com/xaionaro/clsync	7	4	0	11
11498818	apps-modeling	https://github.com/x3dom/apps-modeling	5	6	0	11
11507163	uikit	https://github.com/uikit/uikit	1	3	0	4
11514619	iSenecaPhoto	https://github.com/iesportada/iSenecaPhoto	0	1	0	1
11515428	osm-and-geojson	https://github.com/aaronlidman/osm-and-geojson	2	0	0	2
11526079	openAV-Fabla	https://github.com/harryhaaren/openAV-Fabla	1	0	0	1
11529077	gloubiboulgour	https://github.com/gropax/gloubiboulgour	0	3	0	3
11530283	JSVerbalExpressions	https://github.com/VerbalExpressions/JSVerbalExpressions	0	1	0	1
11530737	johnny-deps	https://github.com/VividCortex/johnny-deps	1	1	0	2
11532046	cl-autowrap	https://github.com/rpav/cl-autowrap	0	1	0	1
11537118	angular-flask	https://github.com/rxl/angular-flask	1	0	0	1
11542346	koop	https://github.com/Esri/koop	0	2	0	2
11546585	freeciv	https://github.com/jheusala/freeciv	1	0	0	1
11546985	flyJenkins	https://github.com/agune/flyJenkins	0	2	0	2
11550362	tap	https://github.com/bkardell/tap	1	0	0	1
11555621	wp-notes	https://github.com/mmnaderi/wp-notes	1	0	0	1
11562177	Ketchup	https://github.com/dbent/Ketchup	2	0	0	2
11563050	sourcedreams.com.br	https://github.com/heltonritter/sourcedreams.com.br	2	0	0	2
11565609	browser-harness	https://github.com/scriby/browser-harness	0	1	0	1
11565688	LiveLeak.bundle	https://github.com/meriko/LiveLeak.bundle	1	0	0	1
11566686	JsDebuggr	https://github.com/rDr4g0n/JsDebuggr	1	0	0	1
11568214	quandl-java	https://github.com/iamtrask/quandl-java	2	0	0	2
11570412	pdf-js-csv	https://github.com/garysieling/pdf-js-csv	5	0	0	5
11580623	mangosthree_server	https://github.com/bels/mangosthree_server	1	0	0	1
11584916	kravsuivi	https://github.com/arnoo/kravsuivi	0	1	0	1
11593414	esteamator	https://github.com/bruceharris/esteamator	1	0	0	1
11597484	todo-list	https://github.com/rogelio-meza-t/todo-list	33	0	0	33
11599400	ros-macports	https://github.com/kyonifer/ros-macports	1	0	0	1
11599760	rust-postgres	https://github.com/sfackler/rust-postgres	1	0	0	1
11599949	docs	https://github.com/koding/docs	1	1	0	2
11600714	beersample-node	https://github.com/couchbaselabs/beersample-node	0	1	0	1
11601014	mdrill	https://github.com/alibaba/mdrill	1	0	0	1
11607818	sntd	https://github.com/caulagi/sntd	1	1	0	2
11613360	cosplay.io_bugs	https://github.com/rickypai/cosplay.io_bugs	1	0	0	1
11616912	Django3Dtools	https://github.com/traverseda/Django3Dtools	4	1	0	5
11617231	exo_browser	https://github.com/spolu/exo_browser	2	3	0	5
11617661	whistle-im	https://github.com/whistle-im/whistle-im	0	2	0	2
11621778	angular-file-upload	https://github.com/danialfarid/angular-file-upload	2	3	0	5
11625621	pr2_simulator	https://github.com/PR2/pr2_simulator	86	47	0	133
11625945	pr2_apps	https://github.com/PR2/pr2_apps	0	1	0	1
11626211	ndt-flash	https://github.com/anantsubramanian/ndt-flash	1	0	0	1
11626478	pr2_navigation_apps	https://github.com/PR2/pr2_navigation_apps	0	1	0	1
11626569	pr2_plugs	https://github.com/PR2/pr2_plugs	68	39	0	107
11626667	pr2_props_stack	https://github.com/PR2/pr2_props_stack	1	1	0	2
11626702	pr2_self_test	https://github.com/PR2/pr2_self_test	0	1	0	1
11635973	observer	https://github.com/simlegate/observer	0	2	0	2
11636397	crisischeckin	https://github.com/HTBox/crisischeckin	1	0	0	1
11637501	fanuc_experimental	https://github.com/ros-industrial/fanuc_experimental	1	0	0	1
11640491	SAFIRA	https://github.com/4Soft/SAFIRA	1	1	0	2
11643597	scripts	https://github.com/nroberts-trulia/scripts	13	0	0	13
11643639	database-scripts	https://github.com/nroberts-trulia/database-scripts	13	0	0	13
11643746	bbGpaApp	https://github.com/ElliottJRo/bbGpaApp	3	1	0	4
11646268	cropper	https://github.com/edmodo/cropper	0	1	0	1
11649531	Rserve	https://github.com/s-u/Rserve	0	1	0	1
11649862	modern.IE-static-code-scan	https://github.com/InternetExplorer/modern.IE-static-code-scan	1	0	0	1
11653497	qanda	https://github.com/atulga/qanda	0	1	0	1
11656189	FlautaSolo	https://github.com/GenosResearchGroup/FlautaSolo	6	3	0	9
11658518	Bachelor-Project-System	https://github.com/BEP-Project/Bachelor-Project-System	1	0	0	1
11659576	cchatsite	https://github.com/phillipzachariah/cchatsite	2	1	0	3
11660327	go-rts-zambia	https://github.com/praekelt/go-rts-zambia	4	2	0	6
11660525	consistent.js	https://github.com/karlvr/consistent.js	0	1	0	1
11661150	wisembly2	https://github.com/Wisembly/wisembly2	17	0	0	17
11662227	jquery.monthCalendar	https://github.com/xquezme/jquery.monthCalendar	1	1	0	2
11664196	angular-layout	https://github.com/filearts/angular-layout	1	1	0	2
11665526	anaconda-issues	https://github.com/ContinuumIO/anaconda-issues	1	0	0	1
11670333	OpenPNM	https://github.com/PMEAL/OpenPNM	2	2	0	4
11672345	tslint	https://github.com/palantir/tslint	1	0	0	1
11675159	SuperDSR	https://github.com/bsima/SuperDSR	1	1	0	2
11677706	dblite	https://github.com/WebReflection/dblite	0	1	0	1
11678024	tik	https://github.com/jarofghosts/tik	1	0	0	1
11678314	noosfero-sgpr	https://github.com/pr-snas/noosfero-sgpr	5	0	0	5
11686252	SCG	https://github.com/QADM/SCG	0	2	0	2
11691118	fiduswriter	https://github.com/fiduswriter/fiduswriter	2	1	0	3
11693709	MCServer	https://github.com/mc-server/MCServer	2	1	0	3
11694714	Tbs	https://github.com/leonardothibes/Tbs	3	0	0	3
11695262	livestreamerJGUI	https://github.com/0wing/livestreamerJGUI	0	1	0	1
11700425	Depenizen	https://github.com/Morphan1/Depenizen	1	0	0	1
11707081	aurbs	https://github.com/asdil12/aurbs	1	0	0	1
11708748	l4cash	https://github.com/matiit/l4cash	1	0	0	1
11711823	django-richenum	https://github.com/hearsaycorp/django-richenum	1	1	0	2
11712839	literalizer	https://github.com/getify/literalizer	2	4	0	6
11713019	sass-foundation	https://github.com/mmcgahan/sass-foundation	1	1	0	2
11713469	JSNMPWalker	https://github.com/tmoskun/JSNMPWalker	4	0	0	4
11718424	fluentassertions	https://github.com/dennisdoomen/fluentassertions	1	0	0	1
11718717	wp_metallic	https://github.com/parmaja/wp_metallic	2	2	0	4
11720297	ASimpleCache	https://github.com/yangfuhai/ASimpleCache	1	0	0	1
11722553	invoice	https://github.com/mettienne/invoice	1	2	0	3
11723339	p5-Riji	https://github.com/Songmu/p5-Riji	0	1	0	1
11724587	BugTracker	https://github.com/Emerald-WoW/BugTracker	1	0	0	1
11725950	kujua-sentinel	https://github.com/medic/kujua-sentinel	2	1	0	3
11726507	nfms-zambia-config	https://github.com/nfms4redd/nfms-zambia-config	1	1	0	2
11729405	gem-jqgrid-jquery-rails	https://github.com/jhx/gem-jqgrid-jquery-rails	1	0	0	1
11729485	SCFusion	https://github.com/Carbon-12/SCFusion	1	0	0	1
11730617	polymania	https://github.com/prototypegames/polymania	3	0	0	3
11731780	js	https://github.com/OOcharts/js	1	1	0	2
11732110	deco3801-them	https://github.com/carlhattenfels/deco3801-them	3	3	0	6
11733464	YDWE	https://github.com/actboy168/YDWE	1	1	0	2
11733970	BungeeSuite	https://github.com/Bloodsplat/BungeeSuite	0	3	0	3
11735414	paris-meetup	https://github.com/ResponsiveImagesCG/paris-meetup	0	1	0	1
11738543	617px.com	https://github.com/617px/617px.com	8	0	0	8
11740750	metridoc-job-cli	https://github.com/metridoc/metridoc-job-cli	1	0	0	1
11740847	MDTickets	https://github.com/mardink/MDTickets	0	2	0	2
11741986	BungeeSuiteChat	https://github.com/Bloodsplat/BungeeSuiteChat	0	2	0	2
11744995	Multisala	https://github.com/dmazzoni/Multisala	2	5	0	7
11747523	Wpf-Learn	https://github.com/syntellect/Wpf-Learn	2	0	0	2
11749698	Malhar	https://github.com/DataTorrent/Malhar	4	4	0	8
11751879	eliom	https://github.com/ocsigen/eliom	0	1	0	1
11752227	DescentMonsters	https://github.com/gabmecu/DescentMonsters	6	1	0	7
11753734	monarch-app	https://github.com/monarch-initiative/monarch-app	1	0	0	1
11760690	ba_gui1	https://github.com/matt-han/ba_gui1	1	0	0	1
11765029	dapp-examples	https://github.com/csantanapr/dapp-examples	0	1	0	1
11765320	bind-table-crud	https://github.com/IonicaBizau/bind-table-crud	1	2	0	3
11768260	koserver	https://github.com/xAKUMAx/koserver	5	1	0	6
11771434	maildown	https://github.com/schneems/maildown	0	1	0	1
11776116	blockly	https://github.com/code-dot-org/blockly	2	0	0	2
11776158	dns-iptables-rules	https://github.com/smurfmonitor/dns-iptables-rules	1	0	0	1
11776507	SimpleLi	https://github.com/Gloooom/SimpleLi	1	1	0	2
11777372	grunt-blanket-mocha	https://github.com/ModelN/grunt-blanket-mocha	1	1	0	2
11778024	firefox-account-bridge	https://github.com/mozilla/firefox-account-bridge	1	0	0	1
11780453	cPMigration	https://github.com/philstark/cPMigration	1	0	0	1
11783583	csscomb.js	https://github.com/csscomb/csscomb.js	0	1	0	1
11790316	Metamaps-Planning	https://github.com/Connoropolous/Metamaps-Planning	2	0	0	2
11793603	dotfiles	https://github.com/Calyhre/dotfiles	1	1	0	2
11793726	scramble	https://github.com/dcposch/scramble	8	1	0	9
11795429	loanschedule	https://github.com/anupanup2001/loanschedule	1	2	0	3
11795565	quarto	https://github.com/avdi/quarto	2	1	0	3
11796705	obsidian_portal_fate	https://github.com/crimsonknave/obsidian_portal_fate	9	6	0	15
11798789	FocusManga	https://github.com/shylux/FocusManga	4	0	0	4
11799689	Tasky	https://github.com/CampDev/Tasky	8	4	0	12
11801020	less-grails-asset-pipeline	https://github.com/bertramdev/less-grails-asset-pipeline	2	2	0	4
11803078	galley	https://github.com/jdcasey/galley	1	0	0	1
11805261	sublime-repository	https://github.com/scribenet/sublime-repository	1	0	0	1
11807248	Enhancemecraft	https://github.com/EnhancedMinecraftTeam/Enhancemecraft	1	0	0	1
11809482	beachy-clean	https://github.com/seamuskc/beachy-clean	4	2	1	7
11811955	gbif	https://github.com/Vizzuality/gbif	3	2	0	5
11812740	COM_SPEC_RIDS	https://github.com/SamCooper/COM_SPEC_RIDS	2	0	0	2
11813608	wp-dependency-minification	https://github.com/x-team/wp-dependency-minification	0	1	0	1
11813884	etcd-ruby	https://github.com/ranjib/etcd-ruby	1	0	0	1
11815677	victims-production	https://github.com/victims/victims-production	2	2	1	5
11815854	ClothesMaker	https://github.com/Octonami/ClothesMaker	0	1	0	1
11820425	parallax	https://github.com/wagerfield/parallax	1	0	0	1
11823644	Rcpp	https://github.com/romainfrancois/Rcpp	0	2	0	2
11825056	aura	https://github.com/forcedotcom/aura	1	0	0	1
11826089	Facile-Framework	https://github.com/Abbe98/Facile-Framework	1	0	0	1
11828772	khan-i18n	https://github.com/Khan/khan-i18n	43	0	0	43
11828795	hep-tycoon	https://github.com/hep-tycoon/hep-tycoon	1	0	0	1
11829404	webservice-automated-tests	https://github.com/nroberts-trulia/webservice-automated-tests	13	0	0	13
11829592	Telerik.OJS	https://github.com/NikolayIT/Telerik.OJS	1	1	0	2
11833740	Dist-Zilla-PluginBundle-Author-YAKEX	https://github.com/yak1ex/Dist-Zilla-PluginBundle-Author-YAKEX	1	2	0	3
11834552	lawless-legends	https://github.com/badvision/lawless-legends	1	0	0	1
11836397	tapassist	https://github.com/godgunman/tapassist	0	6	0	6
11836878	everyvote_mini	https://github.com/everyvote/everyvote_mini	1	0	0	1
11842769	erlang_ale	https://github.com/ivaniacono/erlang_ale	0	1	0	1
11842833	web	https://github.com/TeamBooking/web	1	0	0	1
11844752	libSplash	https://github.com/ComputationalRadiationPhysics/libSplash	3	1	0	4
11844794	core	https://github.com/wardrobecms/core	1	0	0	1
11845170	skll	https://github.com/EducationalTestingService/skll	1	1	0	2
11847370	obsub	https://github.com/aepsil0n/obsub	0	1	0	1
11851668	open-source-search-engine	https://github.com/gigablast/open-source-search-engine	1	1	0	2
11852822	maintenance-filter	https://github.com/CruGlobal/maintenance-filter	1	0	0	1
11855514	hawk	https://github.com/gelisam/hawk	0	1	0	1
11859045	vapor	https://github.com/josefnpat/vapor	2	2	1	5
11859085	PhpLayout	https://github.com/RodionGork/PhpLayout	1	3	0	4
11859742	nb-close-other-projects	https://github.com/markiewb/nb-close-other-projects	1	2	0	3
11860251	pyzmail	https://github.com/aspineux/pyzmail	1	0	0	1
11860895	atomify	https://github.com/Techwraith/atomify	2	1	0	3
11861233	platform	https://github.com/FindMyDog/platform	1	0	0	1
11862780	CelesteProject	https://github.com/luanjunior/CelesteProject	1	1	0	2
11867626	pokemon-reverse-engineering-tools	https://github.com/kanzure/pokemon-reverse-engineering-tools	2	0	0	2
11869237	apeface	https://github.com/alleyse/apeface	1	0	0	1
11869421	farsi_morph_perlex	https://github.com/Kensuke-Mitsuzawa/farsi_morph_perlex	1	0	0	1
11870325	ooc_svo_builder	https://github.com/Forceflow/ooc_svo_builder	0	1	0	1
11870540	CryptoCheat	https://github.com/joubin/CryptoCheat	2	0	0	2
11872800	SMASolution	https://github.com/jmmartinez1985/SMASolution	0	2	0	2
11875606	jsdojo-201310	https://github.com/sapporojs/jsdojo-201310	1	0	0	1
11875978	miranda	https://github.com/orobardet/miranda	0	2	0	2
11877285	Goko-Salvager	https://github.com/aiannacc/Goko-Salvager	1	1	0	2
11879008	Salty-WordPress	https://github.com/humanmade/Salty-WordPress	2	1	0	3
11882558	glowing-core	https://github.com/lightning-project/glowing-core	1	0	0	1
11883581	boxcar	https://github.com/nicinabox/boxcar	1	1	0	2
11884520	orion-jclouds	https://github.com/timur87/orion-jclouds	1	0	0	1
11885273	deckster	https://github.com/42sixsolutions/deckster	0	3	0	3
11888162	j-sql	https://github.com/coderhaoxin/j-sql	2	0	0	2
11890386	Android-App-Widget-IamBullpener	https://github.com/githubsmilo/Android-App-Widget-IamBullpener	1	1	0	2
11891953	faunalia-website	https://github.com/pcav/faunalia-website	1	0	0	1
11892188	gui	https://github.com/docpad/gui	1	0	0	1
11892793	prisme	https://github.com/daniel-menard/prisme	2	6	1	9
11893754	redmine_git_hosting	https://github.com/n-rodriguez/redmine_git_hosting	1	0	0	1
11893843	fitnesse-cppslim	https://github.com/AIM360/fitnesse-cppslim	0	1	0	1
11894308	seafile-client	https://github.com/haiwen/seafile-client	1	0	0	1
11897484	newspub	https://github.com/dmc0re/newspub	0	1	0	1
11899957	lnst	https://github.com/jpirko/lnst	1	2	0	3
11901647	fig-standards	https://github.com/phpDocumentor/fig-standards	1	0	0	1
11903862	collaide	https://github.com/facenord-sud/collaide	1	0	0	1
11905350	beerify	https://github.com/epnet/beerify	1	1	0	2
11906522	measure_it	https://github.com/wearpants/measure_it	0	5	0	5
11908527	deengo-social-issue	https://github.com/evleite/deengo-social-issue	4	0	0	4
11911628	rideSystem	https://github.com/eduardoschneiders/rideSystem	3	2	0	5
11912684	titanium-refresh	https://github.com/frontseat2/titanium-refresh	1	0	0	1
11914512	tox.im	https://github.com/Tox/tox.im	1	0	0	1
11916939	material	https://github.com/DevelopmentPractice201308/material	0	1	0	1
11921041	godfather	https://github.com/PUGX/godfather	0	1	0	1
11922302	alfresco-ubuntu-install	https://github.com/loftuxab/alfresco-ubuntu-install	1	1	0	2
11922563	touch-poi-admin	https://github.com/malmostad/touch-poi-admin	2	1	0	3
11923364	wordpress-core-installer	https://github.com/johnpbloch/wordpress-core-installer	0	1	0	1
11924688	bigNumber	https://github.com/Nishi-Inc/bigNumber	1	0	0	1
11932986	rentica	https://github.com/eigenein/rentica	4	6	0	10
11933914	template-foursquare	https://github.com/Leeflets/template-foursquare	1	0	0	1
11939009	safecopy	https://github.com/acid-state/safecopy	0	2	0	2
11941392	kibana3_auth	https://github.com/christian-marie/kibana3_auth	1	1	0	2
11943692	Newbook-Software	https://github.com/kch349/Newbook-Software	0	1	0	1
11944994	zhuyun	https://github.com/lvlx/zhuyun	13	8	0	21
11945056	dhek	https://github.com/applicius/dhek	5	6	0	11
11945788	pybtex-docutils	https://github.com/mcmtroffaes/pybtex-docutils	1	0	0	1
11951831	l4gettext	https://github.com/netson/l4gettext	1	0	0	1
11955737	timtec	https://github.com/hacklabr/timtec	5	6	0	11
11956601	gnome-citadel	https://github.com/svenkeidel/gnome-citadel	0	1	0	1
11957175	locationtech-events	https://github.com/fosslc/locationtech-events	4	2	0	6
11958904	votainteligente-portal-electoral	https://github.com/ciudadanointeligente/votainteligente-portal-electoral	6	0	0	6
11961362	wristmap	https://github.com/natevw/wristmap	1	1	0	2
11961485	my-workout-diary	https://github.com/BraviSoftware/my-workout-diary	2	1	0	3
11961632	VerbalExpressions-for-Objective-C	https://github.com/boredzo/VerbalExpressions-for-Objective-C	0	2	0	2
11963629	Altium-Script-Central	https://github.com/gbmhunter/Altium-Script-Central	4	1	0	5
11963745	acsp	https://github.com/Bregaida/acsp	0	3	0	3
11976307	freeswitch-rayo-config	https://github.com/chewi/freeswitch-rayo-config	0	1	0	1
11976673	movement	https://github.com/SEEG-Oxford/movement	0	2	0	2
11978867	ProjetoPI2	https://github.com/senacbcc/ProjetoPI2	1	1	0	2
11979174	multisearch	https://github.com/storyful/multisearch	1	2	0	3
11980421	aws-sdk-ios-samples	https://github.com/awslabs/aws-sdk-ios-samples	1	0	0	1
11985523	Migrator	https://github.com/Atex/Migrator	1	1	0	2
11985678	pressmess	https://github.com/michaelflowersky/pressmess	1	0	0	1
11985710	icm.shiffman.net	https://github.com/shiffman/icm.shiffman.net	0	1	0	1
11986447	xournalpp	https://github.com/xournalpp/xournalpp	4	2	0	6
11989824	Caroline	https://github.com/tokuhirom/Caroline	1	2	0	3
11990495	doppelgamer	https://github.com/biffbyrd/doppelgamer	2	3	0	5
11991168	elbping	https://github.com/chooper/elbping	0	1	0	1
11992988	Sherlock	https://github.com/pvandervelde/Sherlock	1	0	0	1
11993845	lessmsi	https://github.com/activescott/lessmsi	0	1	0	1
11996210	stevevallay.github.com	https://github.com/SteveVallay/stevevallay.github.com	0	1	0	1
11996695	minerva	https://github.com/rsamantha/minerva	0	1	0	1
11999183	AKVerbalExpression	https://github.com/akashivskyy/AKVerbalExpression	0	1	0	1
11999261	13in12.com	https://github.com/stiggg/13in12.com	2	0	0	2
12001435	pyblue	https://github.com/ialbert/pyblue	0	1	0	1
12002216	k2	https://github.com/joomlaworks/k2	2	1	0	3
12003834	SeaBattle	https://github.com/EvgeniyMsk/SeaBattle	2	0	0	2
12005359	AngGridBundle	https://github.com/MESD/AngGridBundle	2	0	0	2
12008393	webmaker-profile	https://github.com/gvn/webmaker-profile	0	1	0	1
12008604	missing-puzzle-piece	https://github.com/spectrumbranch/missing-puzzle-piece	1	0	0	1
12008872	MZFormSheetController	https://github.com/m1entus/MZFormSheetController	0	1	0	1
12011961	NodeBind	https://github.com/Polymer/NodeBind	0	1	0	1
12012903	node-flickrapi	https://github.com/Pomax/node-flickrapi	1	1	0	2
12013976	bkz	https://github.com/robertseaton/bkz	4	2	0	6
12014107	ipss20	https://github.com/InterPSS-Project/ipss20	1	0	0	1
12014686	moka-gtk-theme	https://github.com/snwh/moka-gtk-theme	0	0	1	1
12015969	nacho	https://github.com/avelino/nacho	1	0	0	1
12017083	flickrmirror	https://github.com/Pomax/flickrmirror	1	1	0	2
12019063	zf-gearman-manager	https://github.com/tfountain/zf-gearman-manager	1	0	0	1
12020931	languagetool-browser-addon	https://github.com/languagetool-org/languagetool-browser-addon	1	0	0	1
12023116	ignoramos	https://github.com/achan/ignoramos	3	3	0	6
12024403	drupaldev-nginx	https://github.com/digital006/drupaldev-nginx	4	1	0	5
12028107	sphinx-better-theme	https://github.com/irskep/sphinx-better-theme	1	2	0	3
12028618	atopynote	https://github.com/shoheik/atopynote	3	0	0	3
12030454	shopping-list	https://github.com/juanca202/shopping-list	1	0	0	1
12032296	haraf	https://github.com/ciaranmcnulty/haraf	1	1	0	2
12033394	GitFarm	https://github.com/nyantarou/GitFarm	10	0	0	10
12033473	hardsub	https://github.com/torre76/hardsub	1	1	0	2
12034701	laravel-auto-presenter	https://github.com/ShawnMcCool/laravel-auto-presenter	0	1	0	1
12035506	abberatio	https://github.com/kenno87/abberatio	6	0	0	6
12038219	Zillions-of-cardS	https://github.com/larvata/Zillions-of-cardS	1	0	0	1
12038316	atric	https://github.com/killercup/atric	1	0	0	1
12038586	Infos2	https://github.com/Sibyx/Infos2	0	1	0	1
12039116	babynames	https://github.com/nerdwhispers/babynames	2	2	0	4
12039424	drivetocreate.org	https://github.com/DrivetoCreate/drivetocreate.org	2	1	0	3
12041187	LazarusRegistryControls	https://github.com/AlfredGerke/LazarusRegistryControls	1	0	0	1
12042202	cortex	https://github.com/onemanstartup/cortex	1	0	0	1
12042703	bayonne	https://github.com/brunobord/bayonne	1	0	0	1
12044551	rss-api	https://github.com/ajgon/rss-api	8	5	0	13
12048721	EnderIO	https://github.com/CrazyPants/EnderIO	7	4	0	11
12051789	rafbermudez	https://github.com/rafbermudez/rafbermudez	1	0	0	1
12053303	firegento-magesetup	https://github.com/firegento/firegento-magesetup	1	1	0	2
12054362	game	https://github.com/ehaspulat/game	0	2	0	2
12057550	intranet	https://github.com/meverone/intranet	0	2	0	2
12061299	servercontrol	https://github.com/christianklisch/servercontrol	1	1	0	2
12062300	refactor-planning	https://github.com/assemble/refactor-planning	4	0	0	4
12064032	multisite-overview	https://github.com/jokr/multisite-overview	7	7	0	14
12069712	FootballRanking	https://github.com/gpaulu/FootballRanking	1	0	0	1
12076371	vim-gtfo	https://github.com/justinmk/vim-gtfo	1	0	0	1
12077072	oceantodomvc	https://github.com/4lt4i/oceantodomvc	0	1	0	1
12078966	btop	https://github.com/BEORNTech/btop	2	0	0	2
12080551	vegeta	https://github.com/tsenart/vegeta	6	0	0	6
12082924	django-bootstrap3	https://github.com/dyve/django-bootstrap3	2	0	0	2
12083088	GenomeTrackViewer	https://github.com/pvaut/GenomeTrackViewer	1	0	0	1
12084795	clFFT	https://github.com/clMathLibraries/clFFT	0	1	0	1
12086148	xnu	https://github.com/winocm/xnu	0	1	0	1
12086270	hdflvplayer	https://github.com/Apptha/hdflvplayer	1	0	0	1
12087419	hermes-message	https://github.com/sti-uff/hermes-message	0	2	0	2
12088020	ROSforLabview	https://github.com/chris-smith/ROSforLabview	1	0	0	1
12091044	nflpicks	https://github.com/daveashworth/nflpicks	0	1	0	1
12091074	backup_HTA	https://github.com/marco-sorich/backup_HTA	1	0	0	1
12091388	BrowserFS	https://github.com/lavelle/BrowserFS	1	0	0	1
12091807	fresco	https://github.com/clemente-lab/fresco	0	2	0	2
12092904	rookoid	https://github.com/Plonk42/rookoid	1	1	0	2
12094014	DatetimepickerBundle	https://github.com/stephanecollot/DatetimepickerBundle	1	0	0	1
12094910	CodeFirst	https://github.com/NuPattern/CodeFirst	0	23	0	23
12096325	WumpusWorld	https://github.com/TonyAbell/WumpusWorld	1	0	0	1
12097061	yii2-debug	https://github.com/zhuravljov/yii2-debug	0	1	0	1
12098483	twitagent	https://github.com/ingee/twitagent	0	4	0	4
12098698	plank-ios	https://github.com/qszhu/plank-ios	1	0	0	1
12099397	cmchase.github.io	https://github.com/cmchase/cmchase.github.io	3	1	0	4
12102683	webalchemy	https://github.com/skariel/webalchemy	6	0	0	6
12102783	chatphrase	https://github.com/stuartpb/chatphrase	1	0	0	1
12104954	BlackCatCMS_Core	https://github.com/BlackCatDevelopment/BlackCatCMS_Core	1	0	0	1
12105498	gitgraph.js	https://github.com/nicoespeon/gitgraph.js	0	2	0	2
12105833	nantes-nord	https://github.com/nielk/nantes-nord	1	0	0	1
12110516	changes	https://github.com/michaeljoseph/changes	1	0	0	1
12113339	ballhaus	https://github.com/ballhaus/ballhaus	2	0	0	2
12115140	reorder	https://github.com/firstandthird/reorder	0	1	0	1
12116244	PittCodingCracker	https://github.com/etlds/PittCodingCracker	2	0	0	2
12118260	php-application-core-simple-router	https://github.com/zyberWare/php-application-core-simple-router	5	2	0	7
12119347	cloudinary_angular	https://github.com/jbcpollak/cloudinary_angular	1	0	0	1
12119563	HikingGuide	https://github.com/e-gor/HikingGuide	2	3	0	5
12119866	salsa	https://github.com/idbygeorge/salsa	0	1	0	1
12121228	tunny	https://github.com/AnthonyMastrean/tunny	0	1	0	1
12123568	review	https://github.com/amnarciso/review	1	0	0	1
12123976	YAFNET	https://github.com/YAFNET/YAFNET	1	2	0	3
12124545	droonga.org	https://github.com/droonga/droonga.org	1	0	0	1
12125761	leagueManager	https://github.com/PaigePonzeka/leagueManager	1	0	0	1
12126040	rep	https://github.com/ros-industrial/rep	1	0	0	1
12130877	gpss-research	https://github.com/jamesrobertlloyd/gpss-research	5	1	0	6
12131284	reports	https://github.com/BitMobile/reports	1	1	0	2
12133743	aether-issues	https://github.com/aetherteam/aether-issues	0	4	0	4
12136179	nextfile.vim	https://github.com/bighostkim/nextfile.vim	3	3	0	6
12140414	Codiad-CompletePlus	https://github.com/Andr3as/Codiad-CompletePlus	0	1	0	1
12141070	MinVR	https://github.com/MinVR/MinVR	2	0	0	2
12142007	marketplace	https://github.com/registerguard/marketplace	1	1	0	2
12144191	yt-sanegrid	https://github.com/daviddeutsch/yt-sanegrid	1	1	0	2
12146969	simbody	https://github.com/simbody/simbody	0	1	0	1
12152626	Rossignol	https://github.com/opisano/Rossignol	0	1	0	1
12154196	pysenorge	https://github.com/xgeodev/pysenorge	5	0	0	5
12156450	my-pupet	https://github.com/mrVanDalo/my-pupet	1	0	0	1
12158647	pyScheduler	https://github.com/victor-gil-sepulveda/pyScheduler	2	0	0	2
12158938	Diaphanum	https://github.com/Hackfmi/Diaphanum	1	0	0	1
12161221	test	https://github.com/gregrice/test	3	1	0	4
12161481	whereismyfox-app	https://github.com/guilherme-pg/whereismyfox-app	3	1	0	4
12161833	wpengine	https://github.com/socd-io/wpengine	0	4	0	4
12162798	nmis_R_scripts	https://github.com/modilabs/nmis_R_scripts	1	0	0	1
12164779	controls.js	https://github.com/aplib/controls.js	1	0	0	1
12165898	spree_zero_stock_products	https://github.com/swrobel/spree_zero_stock_products	0	1	0	1
12167298	TrackExpenses	https://github.com/debona/TrackExpenses	3	0	0	3
12167321	uiauto	https://github.com/enriquez/uiauto	0	1	0	1
12167614	bluechipstack	https://github.com/bluechiptek/bluechipstack	1	0	0	1
12168488	weiz-grid	https://github.com/syagev/weiz-grid	1	0	0	1
12170794	pr2_delivery	https://github.com/PR2/pr2_delivery	1	0	0	1
12171027	tesla-aether	https://github.com/tesla/tesla-aether	1	0	0	1
12171451	TXE-MASTER-Code	https://github.com/GreatArkStudios/TXE-MASTER-Code	1	0	0	1
12176697	VLC-Security-IP-Solution	https://github.com/lasitha1991/VLC-Security-IP-Solution	0	1	0	1
12177178	sadbot	https://github.com/doidbb/sadbot	1	0	0	1
12179435	adp4j	https://github.com/drapostolos/adp4j	2	0	0	2
12180257	adp	https://github.com/brunoamaral/adp	1	1	0	2
12181014	dcpu_vm	https://github.com/Zardoz89/dcpu_vm	0	1	0	1
12183429	nChatServer	https://github.com/noxx2/nChatServer	1	0	0	1
12184966	spree	https://github.com/ryanhobsonsmith/spree	4	1	0	5
12185080	wowascension-issues	https://github.com/scotty0100/wowascension-issues	3	0	0	3
12187166	words2	https://github.com/bobbymcr/words2	2	0	0	2
12188838	grande.js	https://github.com/mduvall/grande.js	4	2	0	6
12189590	icon_generator	https://github.com/adamnbowen/icon_generator	1	0	0	1
12190067	HackerNewsAPI	https://github.com/thekarangoel/HackerNewsAPI	1	0	0	1
12191592	openspades	https://github.com/yvt/openspades	2	4	0	6
12192285	component-assets	https://github.com/anthonyshort/component-assets	0	1	0	1
12192434	toruzou	https://github.com/toruzou/toruzou	1	0	0	1
12198830	novedadesUmbria	https://github.com/alberovalley/novedadesUmbria	5	2	0	7
12200702	ClassiCube-Client	https://github.com/andrewphorn/ClassiCube-Client	0	1	0	1
12207198	TiISRefreshControl	https://github.com/k0sukey/TiISRefreshControl	4	2	0	6
12211295	openfl-bitfive	https://github.com/YellowAfterlife/openfl-bitfive	0	1	0	1
12212094	Agilitext-Text-Editor	https://github.com/gmcgibbon/Agilitext-Text-Editor	1	1	0	2
12213730	Glide.js	https://github.com/jedrzejchalubek/Glide.js	4	2	0	6
12217087	kanColleWidget	https://github.com/otiai10/kanColleWidget	5	3	0	8
12217898	concrete5-files-cleaner	https://github.com/mlocati/concrete5-files-cleaner	1	0	0	1
12218928	defining-pi	https://github.com/samaaron/defining-pi	0	2	0	2
12219300	cs4	https://github.com/Provoker/cs4	0	2	0	2
12219348	AngularJS-Toaster	https://github.com/jirikavi/AngularJS-Toaster	2	0	0	2
12219790	customelements.io	https://github.com/customelements/customelements.io	1	0	0	1
12222796	metridoc-grails-rid	https://github.com/metridoc/metridoc-grails-rid	1	1	0	2
12223812	fall2013	https://github.com/silshack/fall2013	2	1	0	3
12225708	pagegroup	https://github.com/Dayver/pagegroup	0	1	0	1
12229521	kochiku	https://github.com/square/kochiku	3	1	0	4
12230980	TIR	https://github.com/RequestTI/TIR	1	2	0	3
12231792	drive-web	https://github.com/goodow/drive-web	1	1	0	2
12232622	webacademico	https://github.com/technologs/webacademico	15	0	0	15
12233815	playfij	https://github.com/fijimf/playfij	3	5	0	8
12234242	WebIntent	https://github.com/acen99/WebIntent	1	0	0	1
12234370	tmzg-framework	https://github.com/SmashBrando/tmzg-framework	1	0	0	1
12237053	Acamedia	https://github.com/jnickg/Acamedia	1	0	0	1
12240830	unix_st	https://github.com/dtopn/unix_st	1	0	0	1
12241186	hackage-server	https://github.com/haskell/hackage-server	6	1	0	7
12241742	RegT2_RevisionMake	https://github.com/NiFa18/RegT2_RevisionMake	1	0	0	1
12242095	mongo-jira	https://github.com/jimoleary/mongo-jira	2	0	0	2
12242320	Themis-Service	https://github.com/Themis-J/Themis-Service	1	0	0	1
12242326	bootswatch	https://github.com/evalica/bootswatch	1	1	0	2
12243244	Kleiderkuh	https://github.com/rahoc/Kleiderkuh	6	15	2	23
12243435	node	https://github.com/andrewlow/node	1	0	0	1
12244426	nprogress	https://github.com/rstacruz/nprogress	1	0	0	1
12244838	khmer-protocols	https://github.com/ged-lab/khmer-protocols	1	0	0	1
12245388	INE5404	https://github.com/cco2013-1/INE5404	1	1	0	2
12247548	client	https://github.com/downloadam/client	1	0	0	1
12249246	activityoverlord	https://github.com/irlnathan/activityoverlord	1	0	0	1
12249908	PelletQuest	https://github.com/Lithumist/PelletQuest	2	0	0	2
12252420	rultor-maven-plugin	https://github.com/rultor/rultor-maven-plugin	1	0	0	1
12252747	BeatBot	https://github.com/Cthulahoop/BeatBot	3	0	0	3
12253717	horacontrol	https://github.com/ligadao/horacontrol	7	1	0	8
12255062	VCDB	https://github.com/vz-risk/VCDB	17	22	1	40
12256492	pySlice	https://github.com/matthewelse/pySlice	0	1	0	1
12258966	generator-archetype-jekyll	https://github.com/kwaledesign/generator-archetype-jekyll	2	0	0	2
12258998	Not-Another-Word	https://github.com/Visgean/Not-Another-Word	2	0	0	2
12259343	bobfathers	https://github.com/rgardner/bobfathers	4	1	0	5
12260301	mentor-pairing	https://github.com/Devbootcamp/mentor-pairing	1	1	0	2
12260522	ngProgress	https://github.com/VictorBjelkholm/ngProgress	1	3	0	4
12262573	mcdull525.github.com	https://github.com/mcdull525/mcdull525.github.com	2	0	0	2
12263042	kangxizidian	https://github.com/ksanaforge/kangxizidian	1	0	0	1
12263499	Chess	https://github.com/pdonlon/Chess	0	1	0	1
12266321	azimuth-core	https://github.com/mcrider/azimuth-core	1	0	0	1
12268655	supersupsite	https://github.com/supersupsite/supersupsite	1	0	0	1
12271305	braziljs-light	https://github.com/braziljs/braziljs-light	0	1	0	1
12271305	braziljs-element	https://github.com/braziljs/braziljs-element	1	0	0	1
12272278	time-tracker	https://github.com/pbrogan12/time-tracker	1	0	0	1
12273902	spyglass	https://github.com/andremedeiros/spyglass	0	1	0	1
12274152	lightline.vim	https://github.com/itchyny/lightline.vim	1	0	0	1
12275247	almost-there	https://github.com/acstll/almost-there	2	0	0	2
12279050	eiffel-sudoku	https://github.com/nmaguirre/eiffel-sudoku	0	1	0	1
12280083	Client-Server-Mod	https://github.com/Project-Unite/Client-Server-Mod	1	0	0	1
12281716	Drupal-7-Template	https://github.com/byuweb/Drupal-7-Template	1	0	0	1
12282045	tavi	https://github.com/bnadlerjr/tavi	1	0	0	1
12283230	mh-prog	https://github.com/irrationl/mh-prog	1	0	0	1
12283670	motorm	https://github.com/wsantos/motorm	2	0	0	2
12284127	koa-body-parser	https://github.com/jonathanong/koa-body-parser	1	0	0	1
12284686	dusttrak	https://github.com/gaspacho/dusttrak	2	0	0	2
12284837	trestle	https://github.com/trestle-pm/trestle	2	4	0	6
12284894	acidentes-em-rodovias	https://github.com/matheus-fonseca/acidentes-em-rodovias	0	5	0	5
12286088	ShadowWolf	https://github.com/notionparallax/ShadowWolf	9	0	0	9
12286200	aviator	https://github.com/relaxdiego/aviator	3	0	0	3
12286290	screeneasy	https://github.com/screeneasy/screeneasy	2	0	0	2
12286339	watchem	https://github.com/airportyh/watchem	0	1	0	1
12286813	yamanetoshi	https://github.com/DevelopmentPractice201308/yamanetoshi	1	1	0	2
12287222	ibcomics	https://github.com/ibiwan/ibcomics	0	1	0	1
12287909	clang	https://github.com/clang-omp/clang	1	1	0	2
12288259	insfactor.el	https://github.com/duelinmarkers/insfactor.el	1	0	0	1
12291868	LogReader	https://github.com/ThomasGirard/LogReader	1	0	0	1
12292042	Aziza	https://github.com/Mikedeleeuw/Aziza	1	1	0	2
12292403	boxeebox-xbmc	https://github.com/quarnster/boxeebox-xbmc	1	0	0	1
12295869	SuluContactBundle	https://github.com/massiveart/SuluContactBundle	0	1	0	1
12296327	bitwin	https://github.com/songjiayang/bitwin	2	1	0	3
12296440	MeteorFrontend	https://github.com/frozeman/MeteorFrontend	1	0	0	1
12296473	danzi	https://github.com/nevill/danzi	1	0	0	1
12297483	servicesTest	https://github.com/shootermv/servicesTest	0	1	0	1
12297837	generic-jms-ra	https://github.com/jms-ra/generic-jms-ra	1	1	0	2
12297875	ember-pagination	https://github.com/mharris717/ember-pagination	1	0	0	1
12299112	SuperSweeper	https://github.com/chrismwendt/SuperSweeper	0	1	0	1
12301443	ladybug-installer	https://github.com/raulfraile/ladybug-installer	0	1	0	1
12301980	a_bugs_life	https://github.com/kmanzana/a_bugs_life	1	7	1	9
12303487	dskc-php	https://github.com/shaunlee2004/dskc-php	1	0	0	1
12303509	datejs	https://github.com/abritinthebay/datejs	0	16	0	16
12304015	VideoPile	https://github.com/matthewbaggett/VideoPile	3	3	0	6
12304143	xen-blanket	https://github.com/danlythemanly/xen-blanket	1	0	0	1
12306057	ReportCards	https://github.com/Gimperion/ReportCards	1	2	0	3
12309601	RallyHelpers	https://github.com/ConnerReeves/RallyHelpers	0	1	0	1
12309898	couchbase-lite-android-listener	https://github.com/couchbase/couchbase-lite-android-listener	1	1	0	2
12310030	couchbase-lite-android-core	https://github.com/couchbase/couchbase-lite-android-core	1	1	0	2
12313834	pyboard	https://github.com/philipdexter/pyboard	1	0	0	1
12314382	api	https://github.com/Devbootcamp/api	1	0	0	1
12314484	developer	https://github.com/Devbootcamp/developer	1	1	0	2
12314741	spiff	https://github.com/vito/spiff	1	0	0	1
12317494	smisync	https://github.com/clicordi/smisync	0	3	0	3
12318702	QGIS-Website	https://github.com/qgis/QGIS-Website	1	1	0	2
12319666	lolita	https://github.com/chamzzzzzz/lolita	4	0	0	4
12319723	mod-mysql-postgresql	https://github.com/vert-x/mod-mysql-postgresql	1	2	0	3
12320825	notsuperpong	https://github.com/monkeyannex/notsuperpong	2	0	0	2
12320895	annyang	https://github.com/TalAter/annyang	0	1	0	1
12321044	plugin-Feedcollector	https://github.com/libis/plugin-Feedcollector	1	0	0	1
12323150	SistemaDRH	https://github.com/dipievil/SistemaDRH	4	2	0	6
12323914	PortableHorses	https://github.com/andrepl/PortableHorses	1	1	0	2
12324948	papertrail	https://github.com/nprapps/papertrail	2	1	0	3
12326479	caleydo-doc	https://github.com/Caleydo/caleydo-doc	1	0	0	1
12328385	InfectedPlugin	https://github.com/Official-CreeperCoders/InfectedPlugin	1	0	0	1
12329319	CollaborativeMod	https://github.com/SlimeVoid/CollaborativeMod	2	0	0	2
12330678	SparklrWP	https://github.com/windowsphonehacker/SparklrWP	2	0	0	2
12330726	workflows	https://github.com/chibisov/workflows	0	1	0	1
12331552	engagement-ring	https://github.com/cremalab/engagement-ring	4	6	0	10
12331570	lolitax	https://github.com/chamzzzzzz/lolitax	9	5	0	14
12331989	gst-plugins-cablelabs-ruih	https://github.com/cablelabs/gst-plugins-cablelabs-ruih	0	1	0	1
12332607	chunx	https://github.com/MyRealityCoding/chunx	1	0	0	1
12333651	DIC-Editor-Shortcuts	https://github.com/curtisrutland/DIC-Editor-Shortcuts	2	0	0	2
12333666	iSeriesFitnesse	https://github.com/mikepatrick/iSeriesFitnesse	0	3	0	3
12333672	jekyll-skeleton	https://github.com/littlelazer/jekyll-skeleton	2	0	0	2
12334450	FeedMonkey	https://github.com/jeena/FeedMonkey	1	0	0	1
12334685	markdown-site-template	https://github.com/aplib/markdown-site-template	4	1	0	5
12335495	feedbin	https://github.com/feedbin/feedbin	1	0	0	1
12336435	Practica-TPS	https://github.com/lupitaml04/Practica-TPS	1	0	0	1
12336538	elfeed	https://github.com/skeeto/elfeed	0	1	0	1
12336730	qudt-for-domain-tools	https://github.com/adamnagel/qudt-for-domain-tools	1	0	0	1
12338536	levelmeup	https://github.com/rvagg/levelmeup	3	3	0	6
12338888	cloud9	https://github.com/exsilium/cloud9	1	1	0	2
12340107	cobu-ws-cloud	https://github.com/cobuChris/cobu-ws-cloud	4	3	0	7
12341538	HyundaiCardMusicPlayer	https://github.com/lubang/HyundaiCardMusicPlayer	1	0	0	1
12342300	Support	https://github.com/NapCat-App/Support	1	0	0	1
12342391	WebPalvelinohjelmointi2013	https://github.com/mluukkai/WebPalvelinohjelmointi2013	1	0	0	1
12342990	mangos-three_database	https://github.com/bels/mangos-three_database	3	0	0	3
12344532	graphlib-dot	https://github.com/cpettitt/graphlib-dot	5	1	0	6
12346909	lolologist	https://github.com/arusahni/lolologist	1	2	0	3
12347356	Spell-Editor-GUI	https://github.com/stoneharry/Spell-Editor-GUI	1	1	0	2
12347883	firmata-pi	https://github.com/firmata/firmata-pi	1	0	0	1
12349144	deluminate	https://github.com/abstiles/deluminate	1	0	0	1
12350522	cta	https://github.com/inboundnow/cta	1	0	0	1
12353034	codemirror-elixir-mode	https://github.com/thmzlt/codemirror-elixir-mode	1	0	0	1
12353704	whiteboard-issues	https://github.com/adamblan/whiteboard-issues	1	3	0	4
12354983	lockbox	https://github.com/eloquent/lockbox	3	0	0	3
12355228	Einthusan-Monitor	https://github.com/zambrey/Einthusan-Monitor	0	1	0	1
12355268	yefele	https://github.com/vrtknt/yefele	2	0	0	2
12355435	cl_github	https://github.com/CleverLever/cl_github	7	7	0	14
12355783	whiki	https://github.com/theshaune/whiki	1	0	0	1
12358310	main	https://github.com/art-manager/main	1	0	0	1
12359749	AllForOne	https://github.com/Holf/AllForOne	1	0	0	1
12362313	lsml	https://github.com/EmilyBjoerk/lsml	1	0	0	1
12363498	alfred-wunderlist-workflow	https://github.com/idpaterson/alfred-wunderlist-workflow	1	0	0	1
12363617	graphite-ng	https://github.com/graphite-ng/graphite-ng	2	0	0	2
12364261	Barista	https://github.com/stevestreza/Barista	0	1	0	1
12364583	bootstrap-for-ember	https://github.com/ember-addons/bootstrap-for-ember	0	1	0	1
12366861	chrome-extension	https://github.com/blockPRISM/chrome-extension	2	0	0	2
12367492	website	https://github.com/rhubarbTV/website	10	0	0	10
12368435	The-Game-With-No-Name	https://github.com/Cardude419/The-Game-With-No-Name	1	0	0	1
12368564	flatui.vim	https://github.com/john2x/flatui.vim	1	0	0	1
12368597	FactionRPG	https://github.com/darrinkatz/FactionRPG	1	0	0	1
12370085	drake	https://github.com/marksteve/drake	0	0	1	1
12370262	flashys-stuff	https://github.com/flashman71/flashys-stuff	3	0	0	3
12370378	npmap.js	https://github.com/nationalparkservice/npmap.js	1	2	0	3
12373778	jsonconf	https://github.com/drpoovilleorg/jsonconf	1	0	0	1
12374216	events.groupdc.be	https://github.com/groupdcmarketing/events.groupdc.be	5	4	0	9
12374451	SEO	https://github.com/rockst/SEO	2	0	0	2
12374721	IDLEAnalyzer	https://github.com/Jay-Krish/IDLEAnalyzer	1	0	0	1
12376832	Krypton	https://github.com/pe3zx/Krypton	1	0	0	1
12377879	patchrom_mygica	https://github.com/teoking/patchrom_mygica	2	0	0	2
12378919	barmaids	https://github.com/ole-tange/barmaids	8	5	0	13
12379785	suli	https://github.com/xiongsongsong/suli	1	1	0	2
12380810	FSImageViewer	https://github.com/x2on/FSImageViewer	1	0	0	1
12381024	ProvideInjector	https://github.com/mhohn-hildenbrand/ProvideInjector	1	1	0	2
12382270	chat	https://github.com/bublik/chat	6	1	0	7
12382577	Marvin-Roadmap	https://github.com/kguil/Marvin-Roadmap	0	2	0	2
12383650	share-on-diaspora	https://github.com/ciubotaru/share-on-diaspora	0	1	0	1
12384455	artifactory-debian	https://github.com/jhermann/artifactory-debian	0	1	0	1
12384833	VP8-encoder	https://github.com/anirudhSK/VP8-encoder	1	0	0	1
12385003	writemealist	https://github.com/ScaledSoftware/writemealist	0	3	0	3
12387929	service-locator-demand	https://github.com/mantro/service-locator-demand	1	0	0	1
12388580	statiCK	https://github.com/rpylipow/statiCK	4	1	0	5
12389784	jira_analysis	https://github.com/mvogelgesang/jira_analysis	2	0	0	2
12390030	primus-live	https://github.com/jcw/primus-live	2	0	0	2
12390926	suite_api	https://github.com/cremalab/suite_api	4	2	0	6
12391625	stimuLearning	https://github.com/Restless-ET/stimuLearning	1	0	0	1
12391823	TMS_BID	https://github.com/srt32/TMS_BID	0	2	0	2
12393106	node-neo4js	https://github.com/fumitoito/node-neo4js	0	1	0	1
12396061	ezgliding	https://github.com/rochaporto/ezgliding	1	0	0	1
12398836	tk-textag	https://github.com/bekar/tk-textag	1	1	0	2
12400644	docpad-plugin-inlinegui	https://github.com/docpad/docpad-plugin-inlinegui	1	0	0	1
12403659	indietw	https://github.com/jinkuen/indietw	5	2	0	7
12404317	actions	https://github.com/yandex-qatools/actions	1	0	0	1
12405567	itm_hpc_project	https://github.com/SebastianArnoldt/itm_hpc_project	2	2	0	4
12406144	staff	https://github.com/pavel/staff	1	1	0	2
12407733	site-generator	https://github.com/AlexCharlton/site-generator	0	1	0	1
12408063	issue	https://github.com/hitwhwlj/issue	1	0	0	1
12411135	PLMPackLib	https://github.com/treeDiM/PLMPackLib	0	1	1	2
12412715	SpeciousStation13	https://github.com/zylowalsh/SpeciousStation13	1	0	0	1
12412943	chroma	https://github.com/edsu/chroma	3	0	0	3
12413304	ruby-si-units	https://github.com/gnomex/ruby-si-units	1	1	0	2
12414321	agge	https://github.com/aschroeder/agge	4	1	0	5
12416205	slashbet	https://github.com/Slashat/slashbet	0	1	0	1
12416862	Provenance	https://github.com/jasarien/Provenance	0	1	0	1
12418090	HoustonTracker	https://github.com/utz82/HoustonTracker	1	2	0	3
12418189	controls_and_panels	https://github.com/0xor1/controls_and_panels	2	0	0	2
12418790	test_measure_tmp	https://github.com/bootstraponline/test_measure_tmp	1	0	0	1
12419228	beginner-python	https://github.com/CoderDojoSV/beginner-python	1	0	0	1
12420357	TEST_REPO	https://github.com/jmos1277/TEST_REPO	0	1	0	1
12420508	Sophie-Tracker-3000	https://github.com/MiniCodeMonkey/Sophie-Tracker-3000	2	1	0	3
12420750	blackwater	https://github.com/bitemyapp/blackwater	1	1	0	2
12421943	Lyric-Controller	https://github.com/veadar/Lyric-Controller	1	0	0	1
12423744	txmaker	https://github.com/nicoschtein/txmaker	0	1	0	1
12424971	socially-awkward	https://github.com/justintadlock/socially-awkward	1	1	0	2
12424981	leaderboard	https://github.com/startup-class/leaderboard	1	0	0	1
12429135	emy	https://github.com/EmyLibrary/emy	1	0	0	1
12432974	d23m	https://github.com/DavydenkovM/d23m	0	1	0	1
12434060	babun	https://github.com/reficio/babun	1	0	0	1
12434576	animo.js	https://github.com/ThrivingKings/animo.js	0	1	0	1
12435153	catcorrjs	https://github.com/deanmalmgren/catcorrjs	3	0	0	3
12435477	DataGenerator	https://github.com/FRosner/DataGenerator	5	4	0	9
12437265	pythonstudy	https://github.com/wesky93/pythonstudy	3	5	0	8
12437950	GeolocationBase	https://github.com/Clevis/GeolocationBase	1	0	0	1
12438580	Its-Learning-Reformer	https://github.com/dogbrain/Its-Learning-Reformer	1	0	0	1
12439715	jquery-tagger	https://github.com/Fivium/jquery-tagger	0	2	0	2
12443109	Tims-2Factor-Auth	https://github.com/wbbaddons/Tims-2Factor-Auth	0	1	0	1
12444861	mixen	https://github.com/HubSpot/mixen	1	1	0	2
12445048	BikeFIRMA-backend	https://github.com/boxysean/BikeFIRMA-backend	1	0	0	1
12445718	nephila	https://github.com/timmc/nephila	1	0	0	1
12446365	SwipeMe	https://github.com/kinglozzer/SwipeMe	2	0	0	2
12448510	go-nsq	https://github.com/bitly/go-nsq	1	0	0	1
12450048	android-chromium-view	https://github.com/davisford/android-chromium-view	2	1	0	3
12450837	git-todo	https://github.com/kpdecker/git-todo	1	0	0	1
12452853	migrations	https://github.com/westhouseproject/migrations	1	0	0	1
12454213	wfs-index	https://github.com/usgin/wfs-index	1	2	0	3
12455756	ocDashboard	https://github.com/fjies/ocDashboard	1	0	0	1
12456291	kelprmy-bootstrap	https://github.com/kelprmy/kelprmy-bootstrap	2	2	0	4
12456383	GD-Widgets-Extension	https://github.com/victorlevasseur/GD-Widgets-Extension	3	3	0	6
12457554	akvo-web	https://github.com/akvo/akvo-web	12	1	0	13
12459030	Heaven7	https://github.com/nbmc/Heaven7	0	1	0	1
12460076	FishySigns_CB	https://github.com/nosefish/FishySigns_CB	1	1	0	2
12460293	AnyEvent-Digest	https://github.com/yak1ex/AnyEvent-Digest	1	1	0	2
12462161	formcreator	https://github.com/aivuk/formcreator	1	2	0	3
12464962	pen	https://github.com/sofish/pen	3	0	0	3
12465340	mlr	https://github.com/berndbischl/mlr	1	0	0	1
12468279	cache-studio-esc	https://github.com/KarlPurk/cache-studio-esc	1	0	0	1
12468786	quarterapp	https://github.com/eliasson/quarterapp	1	0	0	1
12472608	Word-Bike-3D	https://github.com/Senior-Project-2013/Word-Bike-3D	16	3	0	19
12473825	YWF	https://github.com/IrinaBelova/YWF	0	1	0	1
12476739	Broadway-on-Ann-iPad	https://github.com/harshavarma/Broadway-on-Ann-iPad	1	0	0	1
12477760	esporte-tec	https://github.com/Uniriotec/esporte-tec	9	0	0	9
12478023	cube-bookstore	https://github.com/kd7iwp/cube-bookstore	1	0	0	1
12478672	apibuilder	https://github.com/brannondorsey/apibuilder	1	1	0	2
12479014	PB-s-Discuzx-2.5	https://github.com/santalex/PB-s-Discuzx-2.5	3	1	0	4
12479188	Unity-XboxCtrlrInput	https://github.com/JISyed/Unity-XboxCtrlrInput	0	1	0	1
12480783	mercator	https://github.com/fontis/mercator	0	1	0	1
12482127	w3c-cheatsheet	https://github.com/dontcallmedom/w3c-cheatsheet	2	0	0	2
12482388	viswow	https://github.com/oikewll/viswow	0	2	0	2
12484851	taintdroid_runner	https://github.com/flankerhqd/taintdroid_runner	1	0	0	1
12485907	mbox_integration	https://github.com/searchisko/mbox_integration	0	1	0	1
12487004	search-journals	https://github.com/scieloorg/search-journals	0	1	0	1
12487300	vk4xmpp	https://github.com/mrDoctorWho/vk4xmpp	1	1	0	2
12489322	Lambda	https://github.com/shirataki/Lambda	1	0	0	1
12489539	dissertation	https://github.com/MKLau/dissertation	8	0	0	8
12489959	shifty	https://github.com/cybrairai/shifty	1	0	0	1
12490417	carousel-plugin	https://github.com/dannyaldridge/carousel-plugin	2	0	0	2
12490779	rss	https://github.com/Sufrostico/rss	0	1	1	2
12491052	queso	https://github.com/libqueso/queso	1	1	0	2
12491419	php-youtube-api	https://github.com/madcoda/php-youtube-api	1	0	0	1
12492180	tntjs	https://github.com/obimod/tntjs	4	0	0	4
12492533	mvz-bird-collection-arctos	https://github.com/museum-of-vertebrate-zoology/mvz-bird-collection-arctos	1	0	0	1
12492602	mvz-egg-and-nest-collection-arctos	https://github.com/museum-of-vertebrate-zoology/mvz-egg-and-nest-collection-arctos	1	0	0	1
12493382	b2tob3	https://github.com/yaph/b2tob3	1	0	0	1
12493595	compressJS.sh	https://github.com/gaberankin/compressJS.sh	1	0	0	1
12496269	InhaParser	https://github.com/DaegiKim/InhaParser	1	0	0	1
12496339	django-save-the-change	https://github.com/karanlyons/django-save-the-change	0	1	0	1
12496351	web-console	https://github.com/rails/web-console	1	0	0	1
12496359	destroy-the-nuduhake	https://github.com/mateusazis/destroy-the-nuduhake	5	2	0	7
12497320	CraftBukkit	https://github.com/beechboy2000/CraftBukkit	1	0	0	1
12498550	quote_machine	https://github.com/jjmasse/quote_machine	2	1	0	3
12500744	grunt-node-inspector	https://github.com/ChrisWren/grunt-node-inspector	1	0	0	1
12501211	weather-on-the-go	https://github.com/GoRated/weather-on-the-go	1	0	0	1
12501437	filmsfortheforest.org	https://github.com/simplyluke/filmsfortheforest.org	1	0	0	1
12502664	A-Detailed-Cplusplus-Concurrency-Tutorial	https://github.com/forhappy/A-Detailed-Cplusplus-Concurrency-Tutorial	1	1	0	2
12503100	OryzaOnline	https://github.com/nehem100/OryzaOnline	1	0	0	1
12503523	Butil	https://github.com/brianehenyo/Butil	1	0	0	1
12503555	RiceCalc	https://github.com/xTraRice/RiceCalc	1	0	0	1
12503595	j2ae	https://github.com/jasonbourne07/j2ae	1	0	0	1
12503706	WeedsLibrary	https://github.com/OnIERo/WeedsLibrary	1	0	0	1
12504176	kriegspiel	https://github.com/binarymax/kriegspiel	1	0	0	1
12504182	salikseeker	https://github.com/craxtech/salikseeker	1	0	0	1
12504784	NodeChat	https://github.com/mangelsnc/NodeChat	1	0	0	1
12504974	XDPlans	https://github.com/xieyajie/XDPlans	3	0	0	3
12506188	ffdecsawrapper	https://github.com/bas-t/ffdecsawrapper	2	1	0	3
12507063	wwtd	https://github.com/grosser/wwtd	1	1	0	2
12508254	hyper-json-spec	https://github.com/cainus/hyper-json-spec	1	0	0	1
12508266	tests-assistant	https://github.com/amirouche/tests-assistant	1	0	0	1
12508397	shinyRGL	https://github.com/trestletech/shinyRGL	0	1	0	1
12509496	teamdash	https://github.com/anxiousmodernman/teamdash	1	0	0	1
12509978	benlimmer.com	https://github.com/l1m5/benlimmer.com	2	0	0	2
12511658	Email-Intelligence	https://github.com/nquinlan/Email-Intelligence	2	0	0	2
12511698	vamk-timetables	https://github.com/OpenLamas/vamk-timetables	2	1	0	3
12512025	youstars	https://github.com/devilshaircut/youstars	1	0	0	1
12512267	pyexplain	https://github.com/LucasMagnum/pyexplain	0	1	0	1
12514517	watcher	https://github.com/hysoftware/watcher	1	0	0	1
12515128	tjsfd2013	https://github.com/richard-ma/tjsfd2013	1	0	0	1
12520740	sublime-sync	https://github.com/florianpaquet/sublime-sync	1	0	0	1
12521224	bizdays	https://github.com/wilsonfreitas/bizdays	4	0	0	4
12522104	faceintegration	https://github.com/Panthera-Framework/faceintegration	1	0	0	1
12524599	iPhysX	https://github.com/andrejoe7/iPhysX	1	0	0	1
12525933	ask	https://github.com/bruderschaft/ask	1	0	0	1
12526251	cohab2	https://github.com/KoFish/cohab2	4	5	0	9
12528043	wallsizer	https://github.com/it-s/wallsizer	5	1	0	6
12530012	TiDKLiveBlur	https://github.com/k0sukey/TiDKLiveBlur	1	0	0	1
12532278	instajob	https://github.com/Instajob/instajob	0	1	0	1
12532622	resource-cloud	https://github.com/sdcsyyg/resource-cloud	1	0	1	2
12532861	QSimage-skins-audio-lang	https://github.com/H15teve/QSimage-skins-audio-lang	1	1	0	2
12533510	kinderhaus	https://github.com/jo/kinderhaus	5	3	0	8
12534087	Quizzes	https://github.com/Hi-Media/Quizzes	2	0	0	2
12535316	PHP-Database-Class	https://github.com/MyXoToD/PHP-Database-Class	0	1	0	1
12536664	OCAPy	https://github.com/pslestang/OCAPy	1	1	0	2
12538452	appmetr-unity	https://github.com/appmetr/appmetr-unity	4	0	0	4
12539041	stalker-admin	https://github.com/tmorozov/stalker-admin	1	1	0	2
12540824	ProgSis	https://github.com/xbrauli0x/ProgSis	2	0	0	2
12542862	ofxAE	https://github.com/nariakiiwatani/ofxAE	0	1	0	1
12543561	floatpoint	https://github.com/flaviojr/floatpoint	3	0	0	3
12545913	dependencies-searcher	https://github.com/smonff/dependencies-searcher	1	0	0	1
12546278	Ren.CMS.NET	https://github.com/nfMalde/Ren.CMS.NET	3	0	0	3
12546875	NonAnalogues	https://github.com/SimonGoring/NonAnalogues	5	0	0	5
12547509	Part-DB	https://github.com/sandboxgangster/Part-DB	1	0	0	1
12548480	satstat	https://github.com/mvglasow/satstat	0	3	0	3
12549281	cite	https://github.com/peterthomasross/cite	2	0	0	2
12549688	Hydra.jl	https://github.com/loladiro/Hydra.jl	1	0	0	1
12549923	pat-facebook	https://github.com/meitar/pat-facebook	1	2	0	3
12550443	haskell-course	https://github.com/fizruk/haskell-course	4	0	0	4
12551888	openstreetmap-json-spec	https://github.com/osmlab/openstreetmap-json-spec	3	0	0	3
12553191	monografia	https://github.com/gurgelrenan/monografia	1	0	0	1
12554828	ffxivapp	https://github.com/Icehunter/ffxivapp	2	0	0	2
12555521	YAAWP	https://github.com/CachingFoX/YAAWP	7	9	0	16
12556467	javaZone2013	https://github.com/andyswift/javaZone2013	8	3	0	11
12556964	itrvision	https://github.com/zycet/itrvision	1	0	1	2
12559765	DemoSquad	https://github.com/ImpactOTheGame/DemoSquad	1	1	0	2
12560699	dragdrop	https://github.com/hyperaudio-dev/dragdrop	1	0	0	1
12561423	jenkins_cli	https://github.com/dev4dev/jenkins_cli	0	1	0	1
12561474	JS-NES-Emulator	https://github.com/Garffan/JS-NES-Emulator	1	0	0	1
12561853	rgbdisplay	https://github.com/douglasjam/rgbdisplay	1	0	0	1
12563072	StaggeredGridView	https://github.com/bulletnoid/StaggeredGridView	1	1	0	2
12563405	bingo	https://github.com/chrisbujok/bingo	1	0	0	1
12563923	Textlab-NLP	https://github.com/andrely/Textlab-NLP	1	0	0	1
12564966	bunt	https://github.com/emilisto/bunt	1	0	0	1
12565003	breeze-php	https://github.com/Neticle/breeze-php	4	0	0	4
12565950	Hubot-Scripts-texttrans	https://github.com/newbcode/Hubot-Scripts-texttrans	2	1	0	3
12567224	Fast_Keys	https://github.com/Tysonzero/Fast_Keys	1	0	0	1
12570567	smartsprite-php	https://github.com/sergeylukin/smartsprite-php	1	2	0	3
12570703	Plagiarism-Checker	https://github.com/architshukla/Plagiarism-Checker	2	2	0	4
12571197	sixteencolors-sandbox	https://github.com/sixteencolors/sixteencolors-sandbox	1	0	0	1
12571435	OAuth2Server	https://github.com/christiansmith/OAuth2Server	1	0	0	1
12572483	prj	https://github.com/shelljs/prj	6	0	0	6
12572599	Signal	https://github.com/TrySignal/Signal	1	1	0	2
12573332	catkin_ws	https://github.com/cmma86/catkin_ws	4	0	0	4
12574039	SnowBrawl	https://github.com/uvbeenzaned/SnowBrawl	1	0	0	1
12574455	mak	https://github.com/guillermoprojaslema/mak	1	0	0	1
12574682	sketch-mol	https://github.com/cefoley/sketch-mol	5	1	0	6
12575399	packages	https://github.com/hubot-scripts/packages	1	1	0	2
12575581	EasyCB-Beta	https://github.com/nikosgram13/EasyCB-Beta	1	0	0	1
12575631	Assignment-1	https://github.com/ui-cs383/Assignment-1	2	3	0	5
12576804	openshift-play2java-cartridge	https://github.com/DennisVis/openshift-play2java-cartridge	2	0	0	2
12578007	Redux-Framework	https://github.com/ReduxFramework/Redux-Framework	10	4	0	14
12579377	poolparty	https://github.com/stereosteve/poolparty	0	1	0	1
12579580	metronome	https://github.com/maranda/metronome	8	3	0	11
12580210	ProgsisPRACTICA1	https://github.com/ozk4r123/ProgsisPRACTICA1	1	0	0	1
12582005	itsuki	https://github.com/bliti/itsuki	0	1	0	1
12582153	MNIMode	https://github.com/chrisinajar/MNIMode	4	1	0	5
12582295	liferay-aui-upgrade-tool	https://github.com/liferay/liferay-aui-upgrade-tool	1	0	0	1
12582882	jekyll-privately_public	https://github.com/brianp/jekyll-privately_public	2	0	0	2
12582950	backdrop-issues	https://github.com/backdrop/backdrop-issues	8	0	0	8
12583144	ckeditor	https://github.com/Pluxopolis/ckeditor	1	0	0	1
12583253	plxMyComRememberMe	https://github.com/Pluxopolis/plxMyComRememberMe	1	1	0	2
12583335	tracker-apps	https://github.com/beat/tracker-apps	1	2	0	3
12583737	brunch-dutch-baby	https://github.com/EnosFeedler/brunch-dutch-baby	0	1	0	1
12588346	testit	https://github.com/ForbesLindesay/testit	1	0	0	1
12589171	DeCoDM	https://github.com/bradkav/DeCoDM	1	0	0	1
12590233	pyircbot	https://github.com/rusvicious/pyircbot	1	0	0	1
12590318	rsoep	https://github.com/mhebing/rsoep	2	0	0	2
12591193	studying-indexing	https://github.com/rafaelpiresm/studying-indexing	0	1	1	2
12592756	EScriptMonkey	https://github.com/adaussy/EScriptMonkey	2	1	0	3
12593159	samlib-Info	https://github.com/monakhv/samlib-Info	1	0	0	1
12593276	NUCtrl	https://github.com/ColinZhang/NUCtrl	3	2	0	5
12595627	textTroll	https://github.com/hugoerg56/textTroll	1	0	0	1
12596921	mobile-feedback	https://github.com/MapofLife/mobile-feedback	13	1	0	14
12597313	findfield	https://github.com/excaza/findfield	0	1	0	1
12597501	apostrophe-site	https://github.com/punkave/apostrophe-site	1	1	0	2
12599719	CS1102	https://github.com/Corinrypkema/CS1102	3	4	0	7
12600001	Questionnaire-Server	https://github.com/Capstone-F13/Questionnaire-Server	3	0	0	3
12600386	sparta	https://github.com/snakeduse/sparta	3	0	0	3
12600985	Questionnaire-App	https://github.com/Capstone-F13/Questionnaire-App	4	0	0	4
12601004	content	https://github.com/droptype/content	1	0	0	1
12602027	duvidas	https://github.com/DPPG-ON/duvidas	0	1	0	1
12602323	acquia-toolbelt	https://github.com/jacobbednarz/acquia-toolbelt	2	0	0	2
12602725	laptop	https://github.com/benhanzl/laptop	0	1	0	1
12602803	OMGMAP	https://github.com/rochepanama/OMGMAP	1	0	0	1
12604336	sguil	https://github.com/bammv/sguil	1	0	0	1
12605017	langgame	https://github.com/krasnoukhov/langgame	1	1	0	2
12606044	xawaash	https://github.com/maherkassim/xawaash	3	0	0	3
12606180	vaas	https://github.com/asouza/vaas	2	0	0	2
12607034	Connections-HTML	https://github.com/shazahm1/Connections-HTML	1	0	0	1
12607168	gpm	https://github.com/pote/gpm	0	1	0	1
12607326	kamawan	https://github.com/bitrip/kamawan	1	1	0	2
12609547	ReleasePlan	https://github.com/Echo3ToEcho7/ReleasePlan	0	1	0	1
12610580	GCW0_REminiscence	https://github.com/ElwingGit/GCW0_REminiscence	0	1	0	1
12610909	KFCocoaPodsPlugin	https://github.com/ricobeck/KFCocoaPodsPlugin	1	0	0	1
12611029	test1	https://github.com/t4k4/test1	1	2	0	3
12611559	yog-2013	https://github.com/umuthan/yog-2013	1	0	0	1
12611880	chat-temp	https://github.com/bazilio91/chat-temp	25	1	0	26
12611968	grunt-applymin	https://github.com/ghosert/grunt-applymin	2	0	0	2
12612315	zone.js	https://github.com/btford/zone.js	1	1	0	2
12614130	accounting	https://github.com/jetthoughts/accounting	3	0	0	3
12615261	KiDSVT	https://github.com/Baltazore/KiDSVT	1	0	0	1
12615330	app	https://github.com/cakephp/app	0	1	0	1
12615355	Digimob-Data-Library	https://github.com/Darutik/Digimob-Data-Library	2	1	0	3
12615539	meteor-desktop	https://github.com/ljudmila-org/meteor-desktop	1	1	0	2
12615804	npd-tvs	https://github.com/jojosati/npd-tvs	0	1	0	1
12616648	Rhetoric	https://github.com/avanov/Rhetoric	2	1	0	3
12617088	xerteonlinetoolkits	https://github.com/thexerteproject/xerteonlinetoolkits	7	2	0	9
12618528	scratchpad	https://github.com/lpsoltys/scratchpad	3	2	0	5
12618937	CodebaseBuilder	https://github.com/hounsell/CodebaseBuilder	3	0	0	3
12620191	miniTodo	https://github.com/yuki1090/miniTodo	2	1	0	3
12620440	snapshot	https://github.com/mattjared/snapshot	0	1	0	1
12620791	memcacheq	https://github.com/Timandes/memcacheq	3	0	0	3
12620972	cluster_search	https://github.com/rasvaan/cluster_search	0	1	0	1
12621644	GLORIACamerasThumbnail	https://github.com/esgg/GLORIACamerasThumbnail	1	0	0	1
12622842	sonar-xquery-plugin	https://github.com/malteseduck/sonar-xquery-plugin	2	0	0	2
12623134	occdat	https://github.com/ropensci/occdat	1	0	0	1
12623293	enaR	https://github.com/TheSeeLab/enaR	5	0	0	5
12623573	margarine-chef	https://github.com/raxsavvy/margarine-chef	5	0	0	5
12624538	STAT545A	https://github.com/jennybc/STAT545A	1	0	0	1
12625642	mktrayicon	https://github.com/Jonhoo/mktrayicon	0	1	0	1
12625665	Frameless-SCSS	https://github.com/ALeMire/Frameless-SCSS	0	1	0	1
12625883	t1m3l1n3	https://github.com/jwormc/t1m3l1n3	1	0	0	1
12626343	GameSocial	https://github.com/bfosberry/GameSocial	1	1	0	2
12627004	testGitAPI	https://github.com/RouganStriker/testGitAPI	23	24	0	47
12627116	Aop	https://github.com/Kdyby/Aop	3	3	0	6
12627170	ArchSimulator	https://github.com/fmilepe/ArchSimulator	0	1	0	1
12627747	SublimeText-Package-Syncing	https://github.com/Chris---/SublimeText-Package-Syncing	0	1	0	1
12628062	stream_ext	https://github.com/theburningmonk/stream_ext	1	3	0	4
12628156	brewapp	https://github.com/keeronmarc/brewapp	1	1	0	2
12628390	PscRepository	https://github.com/ptia/PscRepository	0	1	0	1
12628705	cortado	https://github.com/crcn/cortado	1	0	0	1
12629418	damastes	https://github.com/malmaud/damastes	0	1	0	1
12629910	Chartbuilder	https://github.com/nprapps/Chartbuilder	8	4	0	12
12630042	tese_formato_unico	https://github.com/DPPG-ON/tese_formato_unico	1	1	0	2
12633443	MTS-Ultimate	https://github.com/romsearcher/MTS-Ultimate	1	0	0	1
12634872	test	https://github.com/SudeshnaB/test	2	1	0	3
12635082	smucs	https://github.com/Glavin001/smucs	5	5	1	11
12635333	FortuneDataDsp	https://github.com/bigfortunedata/FortuneDataDsp	0	1	0	1
12635676	r-Cricket-Bot	https://github.com/rreyv/r-Cricket-Bot	3	0	0	3
12635689	LaTeX	https://github.com/2014SeniorProject/LaTeX	2	0	0	2
12638447	geopaparazzi	https://github.com/moovida/geopaparazzi	1	0	0	1
12639171	NODE-dev	https://github.com/hoppfrosch/NODE-dev	4	0	0	4
12639228	caterpillar	https://github.com/rem0temeth0d/caterpillar	1	0	0	1
12641036	DNSPod_API	https://github.com/ljlok/DNSPod_API	1	0	0	1
12641674	RecipeImporter	https://github.com/SlavaBobik/RecipeImporter	0	1	0	1
12643504	HexaPong	https://github.com/fuerchter/HexaPong	3	3	0	6
12643757	PeonOrderSystem	https://github.com/cjmcgraw/PeonOrderSystem	1	4	0	5
12643965	CG_Labs	https://github.com/NecroKote/CG_Labs	1	0	0	1
12644061	WPMVC	https://github.com/y-lohse/WPMVC	2	0	0	2
12644830	Catmandu-XML	https://github.com/gbv/Catmandu-XML	1	0	0	1
12645082	Conference	https://github.com/pd-nmoser/Conference	4	1	0	5
12645884	apm	https://github.com/jmlemetayer/apm	4	0	0	4
12646511	UKMapi	https://github.com/UKMNorge/UKMapi	1	0	0	1
12646681	StaffManager	https://github.com/SkyBirdSoar/StaffManager	0	2	0	2
12646796	cucumber-stddtool	https://github.com/antda/cucumber-stddtool	1	1	0	2
12647598	trust	https://github.com/girving/trust	9	2	0	11
12647696	flu-shot-spec	https://github.com/CityOfPhiladelphia/flu-shot-spec	1	0	0	1
12648906	BufferedParseObserver	https://github.com/bkardell/BufferedParseObserver	0	1	0	1
12649286	phone-home	https://github.com/mewdriller/phone-home	3	1	0	4
12649813	inquiline_network_evolution	https://github.com/MKLau/inquiline_network_evolution	9	0	0	9
12650122	linux-to-gnu	https://github.com/michaeljoseph/linux-to-gnu	1	0	0	1
12651175	RedcapGovernanceDocs	https://github.com/OuhscBbmc/RedcapGovernanceDocs	5	1	0	6
12651306	JACKED	https://github.com/WarrantyNowVoid/JACKED	2	1	0	3
12651809	rapaio	https://github.com/padreati/rapaio	4	0	0	4
12651992	keepassx	https://github.com/samsung-shv-e160/keepassx	0	2	1	3
12652295	rmflight.github.io	https://github.com/rmflight/rmflight.github.io	2	0	0	2
12652529	samatha	https://github.com/rmflight/samatha	2	1	0	3
12652569	files.vim	https://github.com/bighostkim/files.vim	1	1	0	2
12652585	cla-webhook-tests	https://github.com/odewahn/cla-webhook-tests	9	8	0	17
12652872	Milonga	https://github.com/christiansmith/Milonga	2	1	0	3
12653644	studentlog	https://github.com/robtheriault/studentlog	5	0	0	5
12654514	puppet-lumberjack	https://github.com/DanielRedOak/puppet-lumberjack	1	1	0	2
12655685	Xml2CSharp_Prototype	https://github.com/bfriesen/Xml2CSharp_Prototype	2	1	0	3
12656079	microbePlot	https://github.com/danlbek/microbePlot	2	2	0	4
12656103	XML-Struct	https://github.com/nichtich/XML-Struct	4	0	0	4
12656123	QuantumMechanics	https://github.com/TAJG/QuantumMechanics	1	0	0	1
12657240	reviewwithus	https://github.com/michaelrbock/reviewwithus	6	1	0	7
12657281	PureChat	https://github.com/PureChat/PureChat	1	0	0	1
12657872	OrcaJam2013	https://github.com/Sense-of-Right-Alliance/OrcaJam2013	1	0	0	1
12658280	NoReturn	https://github.com/Ironarcher/NoReturn	0	0	1	1
12658400	merry	https://github.com/factrealkuwano/merry	3	0	0	3
12658760	vidium	https://github.com/Raytray/vidium	1	0	0	1
12659365	webdict	https://github.com/ling0322/webdict	0	1	0	1
12659678	wat	https://github.com/namsayin/wat	0	1	0	1
12659754	cakephp-financial	https://github.com/fndomariano/cakephp-financial	2	0	0	2
12660601	Java_Beginner	https://github.com/Bailei/Java_Beginner	1	0	0	1
12660881	async-crawler	https://github.com/nisshiee/async-crawler	1	0	0	1
12660946	ClipVidva-Android	https://github.com/withlovee/ClipVidva-Android	2	0	0	2
12661532	crypto	https://github.com/ostrowr/crypto	0	1	0	1
12662525	AdvancedUnityLogger	https://github.com/gluklichman/AdvancedUnityLogger	2	0	0	2
12662966	PlateCollect	https://github.com/finngaida/PlateCollect	3	0	0	3
12663094	tiradmin	https://github.com/karlito139/tiradmin	2	0	0	2
12663539	using	https://github.com/gonzalo123/using	1	0	0	1
12664138	apartmapp	https://github.com/Jugendhackt/apartmapp	2	0	0	2
12664867	UKMrapporter	https://github.com/UKMNorge/UKMrapporter	3	0	0	3
12666348	SDL_stretch	https://github.com/grepwood/SDL_stretch	1	0	0	1
12666595	caesar_cypher	https://github.com/deadlyraptor/caesar_cypher	0	1	0	1
12666603	gameq	https://github.com/rawright/gameq	0	1	0	1
12667932	yii2-swiftmailer	https://github.com/yiidoc/yii2-swiftmailer	0	1	1	2
12668139	next-divel	https://github.com/AdrianArroyoCalle/next-divel	8	0	0	8
12668240	generator-thorax	https://github.com/walmartlabs/generator-thorax	2	0	0	2
12668631	sfml-ui	https://github.com/mathdu07/sfml-ui	2	0	0	2
12669149	gig	https://github.com/sloria/gig	2	2	0	4
12669684	testing	https://github.com/floroxmar/testing	1	1	0	2
12670459	nw-examples	https://github.com/pfraces-playground/nw-examples	1	0	0	1
12670538	huffduffer	https://github.com/pipwilson/huffduffer	0	1	0	1
12670612	depkit	https://github.com/EthanMichaels/depkit	0	2	0	2
12670807	pendulum	https://github.com/within-/pendulum	0	1	0	1
12670807	shadowircd	https://github.com/shadowircd/shadowircd	1	0	0	1
12670999	strapit	https://github.com/jboho/strapit	12	0	0	12
12671019	backstory	https://github.com/opensorcerer/backstory	3	0	0	3
12671561	docs.wiscacc.org	https://github.com/wiscacc/docs.wiscacc.org	4	0	0	4
12671873	three-arena	https://github.com/vincent/three-arena	2	0	0	2
12672478	furtune_cookie	https://github.com/javierg/furtune_cookie	1	0	0	1
12672704	localhub	https://github.com/pfraces/localhub	1	0	0	1
12672708	speed-dial	https://github.com/nbuhay/speed-dial	5	2	0	7
12674146	dhcp4	https://github.com/krolaw/dhcp4	0	1	0	1
12674586	NodaTime.Humanization	https://github.com/mj1856/NodaTime.Humanization	3	3	1	7
12674731	crime-doesnt-climb	https://github.com/gwintrob/crime-doesnt-climb	3	0	0	3
12674831	yizeng.me	https://github.com/yizeng/yizeng.me	1	1	0	2
12676408	selenium-gradle-example	https://github.com/djangofan/selenium-gradle-example	2	0	0	2
12676845	Test	https://github.com/aortiz49/Test	1	0	0	1
12677130	bitcoin-xchange	https://github.com/kixi/bitcoin-xchange	1	1	0	2
12677322	react-typeahead	https://github.com/fmoo/react-typeahead	2	0	0	2
12677674	lab42_state_machine	https://github.com/RobertDober/lab42_state_machine	4	3	0	7
12677841	warehouse	https://github.com/alexlomax/warehouse	2	2	0	4
12679278	geopacman	https://github.com/Jugendhackt/geopacman	0	1	0	1
12680576	RTFSC_linux_kernel_2013	https://github.com/eslab2013/RTFSC_linux_kernel_2013	2	2	0	4
12680873	Avalon	https://github.com/Timtam/Avalon	4	0	0	4
12680988	HandyImage	https://github.com/Owyn/HandyImage	1	0	0	1
12681101	hurry-app	https://github.com/lipis/hurry-app	4	0	0	4
12681228	test_trestle	https://github.com/trestle-pm/test_trestle	4	6	7	17
12681284	Sylius-Standard	https://github.com/Sylius/Sylius-Standard	1	0	0	1
12681569	house	https://github.com/MKLau/house	2	0	0	2
12682130	jrql	https://github.com/frankleja/jrql	2	0	0	2
12682398	BookExchangeMarket	https://github.com/daydreamqian/BookExchangeMarket	1	0	0	1
12682511	stima-taxi	https://github.com/dieend/stima-taxi	2	0	0	2
12682756	jfeeder	https://github.com/aint/jfeeder	4	0	0	4
12682912	COSMOSpheres	https://github.com/angel-manuel/COSMOSpheres	2	1	0	3
12682996	arcaneoid	https://github.com/gavrilovmiroslav/arcaneoid	3	0	0	3
12683030	canon-jenkins	https://github.com/rackerlabs/canon-jenkins	0	2	0	2
12683402	revel-csrf	https://github.com/cbonello/revel-csrf	1	0	0	1
12683421	couchapp-todo	https://github.com/avanc/couchapp-todo	1	0	0	1
12683496	java-day-app	https://github.com/buzdin/java-day-app	1	0	0	1
12683654	webdriver-recipes	https://github.com/umaar/webdriver-recipes	1	0	0	1
12683750	RallyAPIWrapper.NET	https://github.com/lucasbrendel/RallyAPIWrapper.NET	1	0	0	1
12683890	Puppet-slackpkg	https://github.com/nihlaeth/Puppet-slackpkg	0	1	0	1
12684000	hasatypo	https://github.com/jkokenge/hasatypo	2	0	0	2
12684020	tmassasin	https://github.com/73ddy/tmassasin	5	3	0	8
12684117	urban_metabolism	https://github.com/MKLau/urban_metabolism	3	0	0	3
12684511	holiday-design-shopping	https://github.com/adamaoc/holiday-design-shopping	9	1	0	10
12684687	wordselect	https://github.com/hyperaudio-dev/wordselect	4	2	0	6
12685361	custom-scroll	https://github.com/alexbaumgertner/custom-scroll	6	0	0	6
12685474	generator-ember-laravel	https://github.com/cullymason/generator-ember-laravel	1	2	0	3
12685630	meu_tcc	https://github.com/joaofeliperm/meu_tcc	0	3	0	3
12686610	dreams	https://github.com/therealhappy/dreams	0	2	1	3
12686917	cwac-provider	https://github.com/commonsguy/cwac-provider	1	0	0	1
12687547	ice-cream-magic	https://github.com/pnsji/ice-cream-magic	1	1	0	2
12688002	storage-area-explorer	https://github.com/jusio/storage-area-explorer	2	0	0	2
12688310	geisterchor-automator	https://github.com/MalteJ/geisterchor-automator	1	0	0	1
12688932	WT2013-MillionSong	https://github.com/qutang/WT2013-MillionSong	1	0	0	1
12689097	git-fork	https://github.com/christhekeele/git-fork	1	1	0	2
12689180	browser-refresh	https://github.com/firstandthird/browser-refresh	2	0	0	2
12689301	gravatarjs	https://github.com/mazondo/gravatarjs	0	1	0	1
12689692	population-calculator	https://github.com/ile/population-calculator	1	0	0	1
12689738	arg	https://github.com/swingley/arg	1	0	0	1
12689895	gProxy	https://github.com/dmcall774/gProxy	6	1	0	7
12690182	femr	https://github.com/delasteve/femr	6	1	0	7
12690521	TankMania	https://github.com/xinhaoyuan/TankMania	1	1	0	2
12691110	XcodePlus	https://github.com/payliu/XcodePlus	1	0	0	1
12691479	TheAmpHour_Breakout	https://github.com/ChrisGammell/TheAmpHour_Breakout	1	0	0	1
12691509	guo1234	https://github.com/jinbinguo/guo1234	1	0	0	1
12691773	hotread	https://github.com/rj03hou/hotread	1	1	0	2
12691928	vba-linux	https://github.com/kanzure/vba-linux	1	0	0	1
12692626	Diagonal	https://github.com/ortuagustin/Diagonal	0	1	0	1
12693218	llst	https://github.com/0x7CFE/llst	2	0	0	2
12693304	bay-bar	https://github.com/tastycode/bay-bar	2	0	0	2
12693342	flattery	https://github.com/evendis/flattery	1	0	0	1
12693781	App-GUI	https://github.com/szabgab/App-GUI	16	3	0	19
12694108	ruby	https://github.com/lodarki/ruby	1	0	0	1
12694384	iapservice	https://github.com/wizzat/iapservice	1	1	0	2
12694539	http_wrapper	https://github.com/Svyatov/http_wrapper	2	0	0	2
12695003	drunken-octo-wookie	https://github.com/dshoreman/drunken-octo-wookie	3	0	0	3
12695440	Planets	https://github.com/MarshalW/Planets	1	0	0	1
12695486	dev	https://github.com/bharatbolisetty/dev	1	0	0	1
12695865	uz-tickets	https://github.com/ua-apps/uz-tickets	1	0	0	1
12695975	HelloWorld	https://github.com/mhasan2003mitul/HelloWorld	1	1	1	3
12696008	ansible-kick	https://github.com/kelseyhightower/ansible-kick	6	1	0	7
12696081	tsks-app	https://github.com/martinlabuschin/tsks-app	12	4	0	16
12696085	symfony1	https://github.com/nykopol/symfony1	1	1	0	2
12696170	soepR	https://github.com/mhebing/soepR	2	0	0	2
12696402	rus-exp	https://github.com/bool-rus/rus-exp	1	1	0	2
12696476	bankcard-input	https://github.com/hulufei/bankcard-input	1	0	0	1
12696630	Application1	https://github.com/zakyshareef/Application1	1	1	1	3
12696904	scct	https://github.com/SCCT/scct	30	0	0	30
12697458	TiledMapGameExample	https://github.com/tekeiro/TiledMapGameExample	6	0	0	6
12697543	Kruto	https://github.com/successus/Kruto	4	1	0	5
12697604	errorpages	https://github.com/janoszen/errorpages	2	0	0	2
12697668	UKMTV-Embed	https://github.com/UKMNorge/UKMTV-Embed	1	1	0	2
12698557	easytranscript	https://github.com/Elmari/easytranscript	1	0	0	1
12698642	bitcoin	https://github.com/miguelrochefort/bitcoin	10	0	0	10
12698642	Bitcoin-for-Windows-Phone	https://github.com/miguelrochefort/Bitcoin-for-Windows-Phone	5	1	0	6
12698650	RUCM----	https://github.com/wuxue11/RUCM----	1	0	0	1
12698660	web-audio-api	https://github.com/olivierthereaux/web-audio-api	274	2	0	276
12698695	jquery-board	https://github.com/clamz/jquery-board	2	0	0	2
12698954	marshmallow	https://github.com/oh240/marshmallow	2	0	0	2
12699084	web-audio-api	https://github.com/olivierthereaux/web-audio-api	659	36	0	695
12699194	All-To-DPS	https://github.com/RedactiePartners/All-To-DPS	2	0	0	2
12699339	android_kernel_msm8x25	https://github.com/FreeQRD/android_kernel_msm8x25	1	0	0	1
12699406	spielvolk	https://github.com/haslo/spielvolk	9	0	0	9
12699521	bands-sweetleetrio	https://github.com/jdonson/bands-sweetleetrio	3	0	0	3
12699651	Test	https://github.com/lanstudios/Test	1	0	0	1
12699693	AnyEvent-Git-Wrapper	https://github.com/plicease/AnyEvent-Git-Wrapper	4	2	0	6
12699996	conkeror	https://github.com/brain1ac/conkeror	10	0	0	10
12700014	PHP-Tools	https://github.com/asika32764/PHP-Tools	1	0	0	1
12700033	TD-shortcodes	https://github.com/Mikedeleeuw/TD-shortcodes	4	0	0	4
12700072	emacs	https://github.com/brain1ac/emacs	1	0	0	1
12700195	tcsh	https://github.com/brain1ac/tcsh	8	0	0	8
12700269	innvolve	https://github.com/dalph/innvolve	1	0	0	1
12700299	badger	https://github.com/yetti/badger	3	2	1	6
12700433	MobilityAnalyzer	https://github.com/michburkhalter/MobilityAnalyzer	3	0	0	3
12700610	webmin-couchbase-module	https://github.com/YakindanEgitim/webmin-couchbase-module	5	0	0	5
12700647	slides-statusreport	https://github.com/GDGBremen/slides-statusreport	1	0	0	1
12700733	firefox	https://github.com/brain1ac/firefox	1	0	0	1
12700793	knowyourmp	https://github.com/obshtestvo/knowyourmp	1	0	0	1
12700897	cmd	https://github.com/brain1ac/cmd	2	0	0	2
12700941	ahk	https://github.com/brain1ac/ahk	2	0	0	2
12701116	Stack	https://github.com/kuss/Stack	3	0	0	3
12701289	python	https://github.com/brain1ac/python	2	0	0	2
12701363	TPS	https://github.com/MattScherzer/TPS	5	1	0	6
12701392	test	https://github.com/cmfcmf/test	1	0	0	1
12701417	windows	https://github.com/brain1ac/windows	2	0	0	2
12701747	InfoScreen	https://github.com/Zhiran/InfoScreen	2	0	0	2
12702060	sgCAD	https://github.com/devalicious/sgCAD	8	1	0	9
12702295	adpac	https://github.com/zongai/adpac	1	0	0	1
12702391	InDesignEPUBCheck	https://github.com/grefel/InDesignEPUBCheck	1	0	0	1
12702498	ss-ms1-uitest	https://github.com/snowmantw/ss-ms1-uitest	3	2	0	5
12702563	testRepo	https://github.com/GitNiko/testRepo	3	3	0	6
12702646	ARENA-M-TRINKET	https://github.com/zunuk1/ARENA-M-TRINKET	1	0	0	1
12702771	bloomclj	https://github.com/vedang/bloomclj	3	0	0	3
12703120	homeupgrade	https://github.com/sebbacon/homeupgrade	9	0	0	9
12703420	med	https://github.com/rafaacheti/med	7	0	0	7
12703424	gaepagseguro	https://github.com/renzon/gaepagseguro	3	3	0	6
12703604	MED	https://github.com/medadvocacia/MED	3	0	0	3
12704037	home	https://github.com/ChuckHa/home	7	2	0	9
12704254	wellknown	https://github.com/mapbox/wellknown	4	1	0	5
12704606	Huboard	https://github.com/JVeerman/Huboard	10	3	0	13
12704905	timetracks	https://github.com/alcdev/timetracks	1	0	0	1
12705400	Gamsbaer	https://github.com/CoachTom/Gamsbaer	1	0	0	1
12705457	mkadmin	https://github.com/mkdarkness/mkadmin	3	0	0	3
12705577	Authentication	https://github.com/aFreshKiwi/Authentication	1	1	0	2
12705930	Rock-Paper-Scissor--	https://github.com/omarhaffar/Rock-Paper-Scissor--	1	0	0	1
12705970	SLSVGKit	https://github.com/shuoli84/SLSVGKit	1	0	0	1
12706049	jquery-django-formset	https://github.com/treyhunner/jquery-django-formset	1	0	0	1
12706085	DatingSite	https://github.com/kfelton/DatingSite	2	1	1	4
12706103	BattleLink	https://github.com/sdobart/BattleLink	2	0	0	2
12706141	APC	https://github.com/ClutchTortoise/APC	1	1	0	2
12706203	computer-vision	https://github.com/Self-Driving-Vehicle/computer-vision	5	0	0	5
12706247	EthanZ.me	https://github.com/HorZ/EthanZ.me	1	0	0	1
12706272	geojsonio-cli	https://github.com/mapbox/geojsonio-cli	3	0	0	3
12706660	LinkUp	https://github.com/ajcummins/LinkUp	12	1	0	13
12706746	Projektmanagement	https://github.com/SethosII/Projektmanagement	2	1	0	3
12707014	ARNA	https://github.com/cmbennett/ARNA	3	0	0	3
12707107	UseGit	https://github.com/ooprogramador/UseGit	1	0	0	1
12707430	DMCEdit-	https://github.com/jtf323/DMCEdit-	3	0	0	3
12707493	borderless	https://github.com/lulebe/borderless	2	0	0	2
12707581	payable	https://github.com/makingdevs/payable	3	1	0	4
12707901	php-application-core-php-view	https://github.com/zyberWare/php-application-core-php-view	2	1	0	3
12708236	Progress-Block	https://github.com/Bulwersator/Progress-Block	9	0	0	9
12708347	multiblas	https://github.com/fommil/multiblas	5	0	0	5
12708570	leitor_log	https://github.com/joaogabriel/leitor_log	5	0	0	5
12708760	p5-ITK	https://github.com/zmughal/p5-ITK	2	0	0	2
12709058	hack	https://github.com/cyberdelia/hack	1	0	0	1
12709090	trestle_test	https://github.com/abierbaum/trestle_test	2	1	0	3
12709349	file-manager	https://github.com/MartijnR/file-manager	1	0	0	1
12709462	test	https://github.com/anupkejriwal/test	2	1	0	3
12709686	media_mediahub	https://github.com/unlcms/media_mediahub	1	1	0	2
12709704	teste	https://github.com/ronnyvieiracruz/teste	1	0	0	1
12709837	f	https://github.com/fanar1/f	1	0	0	1
12709888	tp	https://github.com/vitaliyp/tp	1	0	0	1
12709959	test1	https://github.com/markokruustuk/test1	18	0	0	18
12710185	coding-standards	https://github.com/Adobe-Consulting-Services/coding-standards	4	4	0	8
12710356	google_injector	https://github.com/rvandenberge/google_injector	1	1	0	2
12710570	color	https://github.com/brain1ac/color	1	0	0	1
12710594	Joomla3Bootstrap3	https://github.com/micheldejoode/Joomla3Bootstrap3	1	0	0	1
12710612	polymer-bootstrap	https://github.com/PascalPrecht/polymer-bootstrap	2	0	0	2
12710641	MineFactoryReloaded	https://github.com/samrg472/MineFactoryReloaded	2	0	0	2
12710652	acumensolutions	https://github.com/acumen-solutions/acumensolutions	1	0	0	1
12710708	tile	https://github.com/brain1ac/tile	1	0	0	1
12710754	AudioMotionEtude_1	https://github.com/jmwohl/AudioMotionEtude_1	1	1	0	2
12710861	telnet-probe	https://github.com/arturosevilla/telnet-probe	2	1	0	3
12710876	pidgin	https://github.com/brain1ac/pidgin	1	0	0	1
12710964	unity-vr	https://github.com/Laremere/unity-vr	1	0	0	1
12711041	tasteR	https://github.com/MKLau/tasteR	1	0	0	1
12711093	covet	https://github.com/testdouble/covet	3	0	0	3
12711172	DementiaEngine	https://github.com/fstp/DementiaEngine	1	0	0	1
12711813	FIlled---HELP	https://github.com/monkeydagger2013/FIlled---HELP	1	0	0	1
12712042	Parsonshd-xcode	https://github.com/wentin/Parsonshd-xcode	1	0	0	1
12712339	kwbbdev	https://github.com/taylortbb/kwbbdev	3	1	0	4
12712533	AndroidScreenProperties	https://github.com/kevincarlson/AndroidScreenProperties	1	0	0	1
12712609	INO-Calc-Project	https://github.com/daraeman/INO-Calc-Project	3	2	0	5
12712925	BitEcology	https://github.com/BitEcology/BitEcology	8	0	0	8
12713237	twitterclient	https://github.com/sachishah/twitterclient	1	0	0	1
12713579	go-pushbots	https://github.com/FunOrDieLTD/go-pushbots	2	0	0	2
12713588	testing-stuff	https://github.com/acgti/testing-stuff	1	0	0	1
12713600	MyFirstJavaUnitTestingGit	https://github.com/PetitPrince13/MyFirstJavaUnitTestingGit	1	0	0	1
12713718	bentley_mcilroy	https://github.com/aprescott/bentley_mcilroy	2	0	0	2
12713802	planning	https://github.com/savioke/planning	11	0	0	11
12714366	inceno	https://github.com/baweaver/inceno	5	0	0	5
12715047	test	https://github.com/iplog/test	1	0	0	1
12715409	fundscout	https://github.com/romanofski/fundscout	3	0	0	3
12715497	Node-StrapKit	https://github.com/Glavin001/Node-StrapKit	3	0	0	3
12715592	issuer	https://github.com/pfraces/issuer	1	0	0	1
12715819	cw	https://github.com/egrachev/cw	1	0	0	1
12715889	addoncode	https://github.com/ClutchTortoise/addoncode	2	0	0	2
12716026	findit	https://github.com/drapergeek/findit	3	0	0	3
12716422	gnuhub_deepin	https://github.com/gnuhub/gnuhub_deepin	1	0	0	1
12716643	RTFSC_Linux_Kernel	https://github.com/eslab2013-ustc/RTFSC_Linux_Kernel	1	0	0	1
12716987	Big-Little-Picker	https://github.com/smilack/Big-Little-Picker	1	0	0	1
12716999	LedCtl	https://github.com/taigi0909/LedCtl	1	0	0	1
12717335	dd-backlog	https://github.com/mindexed/dd-backlog	3	0	0	3
12717337	flask-blog	https://github.com/a-tux/flask-blog	3	0	0	3
12717394	requirements-zen	https://github.com/Bjorn32/requirements-zen	3	0	0	3
12717780	test123	https://github.com/markokruustuk/test123	18	1	1	20
12718023	cdtank	https://github.com/cdtank/cdtank	1	0	0	1
12718057	light-sockets	https://github.com/rhodey/light-sockets	1	0	0	1
12718147	multisecretpad	https://github.com/santagada/multisecretpad	4	0	0	4
12718172	blog	https://github.com/ljwsummer/blog	1	0	0	1
12718281	SportsWall	https://github.com/jel-massih/SportsWall	7	0	0	7
12718402	pyro_module_forums	https://github.com/wbc-mike/pyro_module_forums	1	0	0	1
12718414	CrawlMovie	https://github.com/zhuao/CrawlMovie	1	0	0	1
12719169	CitationsFromBarcodes	https://github.com/spurioso/CitationsFromBarcodes	7	0	0	7
12719557	test	https://github.com/rsurikov/test	1	2	1	4
12719875	Django-Forum	https://github.com/Sedushi/Django-Forum	1	1	0	2
12719891	swapdir	https://github.com/Enelar/swapdir	1	1	0	2
12719953	massive-dynamic	https://github.com/brandonmeredyk/massive-dynamic	1	0	0	1
12720017	essay	https://github.com/kurisuwhyte/essay	1	0	0	1
12720546	github-testing-site	https://github.com/hottubb/github-testing-site	2	2	0	4
12720725	test	https://github.com/teppeis/test	1	0	0	1
12720757	MyGameProjectTest	https://github.com/zeliard/MyGameProjectTest	2	0	0	2
12721232	demo_angel	https://github.com/blackzky/demo_angel	1	0	0	1
12721433	meetups	https://github.com/bevry/meetups	1	0	0	1
12721489	htaccess.madewithlove.be	https://github.com/madewithlove/htaccess.madewithlove.be	11	1	0	12
