select8::user	select8::url	select8::opened_count	select8::closed_count	select8::reopened_count	select8::total_actions_count
1u	https://github.com/1u	0	1	0	1
7a	https://github.com/7a	1	0	0	1
NV	https://github.com/NV	1	0	0	1
cj	https://github.com/cj	1	0	0	1
dw	https://github.com/dw	2	1	0	3
jg	https://github.com/jg	1	0	0	1
jo	https://github.com/jo	5	3	0	8
mc	https://github.com/mc	1	0	0	1
np	https://github.com/np	1	0	0	1
pv	https://github.com/pv	0	4	0	4
rf	https://github.com/rf	1	1	0	2
ys	https://github.com/ys	1	0	0	1
Rua	https://github.com/Rua	1	0	0	1
abn	https://github.com/abn	6	3	1	10
am4	https://github.com/am4	1	0	0	1
ane	https://github.com/ane	1	1	0	2
arv	https://github.com/arv	0	2	0	2
ask	https://github.com/ask	1	1	0	2
ctb	https://github.com/ctb	3	1	0	4
cvb	https://github.com/cvb	0	2	0	2
dag	https://github.com/dag	0	1	0	1
db0	https://github.com/db0	0	1	0	1
dfm	https://github.com/dfm	3	27	0	30
did	https://github.com/did	1	0	0	1
doy	https://github.com/doy	0	2	0	2
fdv	https://github.com/fdv	11	0	0	11
ggl	https://github.com/ggl	1	0	0	1
h2s	https://github.com/h2s	0	1	0	1
hcf	https://github.com/hcf	0	1	0	1
hoh	https://github.com/hoh	1	0	0	1
hvr	https://github.com/hvr	2	0	0	2
ile	https://github.com/ile	1	0	0	1
ipf	https://github.com/ipf	3	0	0	3
jan	https://github.com/jan	1	0	0	1
jch	https://github.com/jch	0	1	0	1
jcw	https://github.com/jcw	3	1	0	4
jdm	https://github.com/jdm	3	1	0	4
jhx	https://github.com/jhx	1	0	0	1
jjb	https://github.com/jjb	0	1	1	2
jnm	https://github.com/jnm	2	0	0	2
jrk	https://github.com/jrk	1	0	0	1
k2s	https://github.com/k2s	1	0	0	1
k4k	https://github.com/k4k	0	2	2	4
kal	https://github.com/kal	0	1	0	1
kpp	https://github.com/kpp	2	0	0	2
kud	https://github.com/kud	1	0	0	1
kul	https://github.com/kul	1	0	0	1
ldx	https://github.com/ldx	0	2	0	2
lmj	https://github.com/lmj	0	1	0	1
lou	https://github.com/lou	0	1	0	1
lqi	https://github.com/lqi	0	1	0	1
lsv	https://github.com/lsv	1	0	0	1
ltw	https://github.com/ltw	1	0	0	1
m90	https://github.com/m90	0	1	0	1
mdo	https://github.com/mdo	0	6	0	6
mdp	https://github.com/mdp	0	2	0	2
mhl	https://github.com/mhl	1	0	0	1
mwl	https://github.com/mwl	1	2	0	3
ngn	https://github.com/ngn	0	1	0	1
nh2	https://github.com/nh2	1	0	0	1
njx	https://github.com/njx	0	3	0	3
nlf	https://github.com/nlf	1	1	0	2
nov	https://github.com/nov	0	1	0	1
ozh	https://github.com/ozh	0	2	0	2
pe3	https://github.com/pe3	1	0	0	1
peq	https://github.com/peq	0	1	0	1
phw	https://github.com/phw	0	1	0	1
pid	https://github.com/pid	1	1	0	2
pld	https://github.com/pld	0	1	0	1
qcz	https://github.com/qcz	1	0	0	1
qii	https://github.com/qii	0	2	0	2
rdp	https://github.com/rdp	0	1	0	1
rf-	https://github.com/rf-	0	1	0	1
rkh	https://github.com/rkh	4	1	0	5
rr-	https://github.com/rr-	1	0	0	1
ryw	https://github.com/ryw	1	1	0	2
s-u	https://github.com/s-u	0	1	0	1
san	https://github.com/san	1	0	0	1
skx	https://github.com/skx	0	3	0	3
smn	https://github.com/smn	2	0	0	2
ssp	https://github.com/ssp	1	0	0	1
tap	https://github.com/tap	1	0	0	1
taq	https://github.com/taq	0	1	0	1
th7	https://github.com/th7	2	2	0	4
tmk	https://github.com/tmk	1	1	0	2
vic	https://github.com/vic	1	0	0	1
vid	https://github.com/vid	1	0	0	1
wch	https://github.com/wch	2	1	0	3
whg	https://github.com/whg	0	1	0	1
xta	https://github.com/xta	0	1	0	1
y-p	https://github.com/y-p	2	1	1	4
yed	https://github.com/yed	1	0	0	1
yvt	https://github.com/yvt	0	3	0	3
yyr	https://github.com/yyr	0	2	0	2
z-a	https://github.com/z-a	1	0	0	1
zwn	https://github.com/zwn	1	1	0	2
130s	https://github.com/130s	1	0	0	1
2011	https://github.com/2011	0	1	0	1
3con	https://github.com/3con	1	0	0	1
42he	https://github.com/42he	1	0	0	1
6a68	https://github.com/6a68	0	1	0	1
Adys	https://github.com/Adys	2	0	0	2
Amab	https://github.com/Amab	1	0	0	1
Ayrx	https://github.com/Ayrx	1	0	0	1
CaDs	https://github.com/CaDs	1	0	0	1
DeaR	https://github.com/DeaR	1	0	0	1
DevL	https://github.com/DevL	0	1	0	1
Divi	https://github.com/Divi	0	2	0	2
Fant	https://github.com/Fant	0	1	0	1
Holf	https://github.com/Holf	1	0	0	1
HorZ	https://github.com/HorZ	1	0	0	1
Kami	https://github.com/Kami	1	0	0	1
Kbre	https://github.com/Kbre	1	0	0	1
Laar	https://github.com/Laar	1	0	0	1
M211	https://github.com/M211	1	0	0	1
M66B	https://github.com/M66B	0	2	0	2
MiLk	https://github.com/MiLk	1	0	0	1
MoOx	https://github.com/MoOx	1	0	0	1
Mtnt	https://github.com/Mtnt	1	1	0	2
Nygu	https://github.com/Nygu	7	2	0	9
PAEz	https://github.com/PAEz	2	0	0	2
PeMu	https://github.com/PeMu	0	1	0	1
SeyZ	https://github.com/SeyZ	1	0	0	1
Simn	https://github.com/Simn	0	1	0	1
TAJG	https://github.com/TAJG	1	0	0	1
Tux2	https://github.com/Tux2	0	2	0	2
Weem	https://github.com/Weem	1	0	0	1
Xemi	https://github.com/Xemi	1	0	0	1
aTei	https://github.com/aTei	1	0	0	1
acds	https://github.com/acds	1	0	0	1
ad29	https://github.com/ad29	1	0	0	1
aint	https://github.com/aint	4	0	0	4
ajf8	https://github.com/ajf8	0	1	0	1
aler	https://github.com/aler	1	0	0	1
also	https://github.com/also	1	0	0	1
ankr	https://github.com/ankr	0	1	0	1
asaf	https://github.com/asaf	0	2	0	2
avsm	https://github.com/avsm	0	1	0	1
ax3l	https://github.com/ax3l	2	0	0	2
axmo	https://github.com/axmo	1	0	0	1
azer	https://github.com/azer	1	0	0	1
bear	https://github.com/bear	2	0	0	2
beat	https://github.com/beat	1	2	0	3
bels	https://github.com/bels	4	0	0	4
bors	https://github.com/bors	0	1	0	1
cben	https://github.com/cben	2	0	0	2
cluy	https://github.com/cluy	4	0	0	4
crcn	https://github.com/crcn	3	1	0	4
ctll	https://github.com/ctll	1	0	0	1
cyle	https://github.com/cyle	1	0	0	1
d1rk	https://github.com/d1rk	0	1	0	1
dgeb	https://github.com/dgeb	0	1	0	1
dovy	https://github.com/dovy	10	26	0	36
dpup	https://github.com/dpup	0	2	0	2
drak	https://github.com/drak	2	2	0	4
duns	https://github.com/duns	14	2	0	16
dvor	https://github.com/dvor	1	1	0	2
dyaa	https://github.com/dyaa	2	0	0	2
eaxs	https://github.com/eaxs	0	2	0	2
edsu	https://github.com/edsu	3	0	0	3
estk	https://github.com/estk	1	0	0	1
fexo	https://github.com/fexo	1	0	0	1
fieg	https://github.com/fieg	1	0	0	1
fixx	https://github.com/fixx	0	3	0	3
fmoo	https://github.com/fmoo	2	0	0	2
fmos	https://github.com/fmos	1	1	0	2
fstp	https://github.com/fstp	1	0	0	1
g1ra	https://github.com/g1ra	1	0	0	1
gk0r	https://github.com/gk0r	0	2	0	2
gr2m	https://github.com/gr2m	1	3	0	4
halo	https://github.com/halo	0	1	0	1
hayd	https://github.com/hayd	1	1	0	2
hbli	https://github.com/hbli	0	1	0	1
heff	https://github.com/heff	0	3	0	3
hg42	https://github.com/hg42	0	1	0	1
hhgs	https://github.com/hhgs	4	0	0	4
hjpa	https://github.com/hjpa	1	0	0	1
hluk	https://github.com/hluk	1	0	0	1
hone	https://github.com/hone	1	1	0	2
hool	https://github.com/hool	1	0	0	1
href	https://github.com/href	0	2	0	2
iBaa	https://github.com/iBaa	0	1	0	1
ialx	https://github.com/ialx	1	0	0	1
ianb	https://github.com/ianb	0	1	0	1
it-s	https://github.com/it-s	2	0	0	2
iwyg	https://github.com/iwyg	1	1	0	2
iziz	https://github.com/iziz	0	2	0	2
jace	https://github.com/jace	1	0	0	1
jawi	https://github.com/jawi	0	0	1	1
jcai	https://github.com/jcai	1	0	0	1
jdee	https://github.com/jdee	0	3	0	3
jden	https://github.com/jden	1	0	0	1
jjok	https://github.com/jjok	1	0	0	1
jokr	https://github.com/jokr	7	7	0	14
jrgm	https://github.com/jrgm	1	0	0	1
jrha	https://github.com/jrha	8	0	0	8
jrhe	https://github.com/jrhe	0	1	0	1
kaos	https://github.com/kaos	1	1	0	2
keul	https://github.com/keul	0	2	1	3
kigu	https://github.com/kigu	1	0	0	1
kixi	https://github.com/kixi	1	1	0	2
kmdm	https://github.com/kmdm	0	1	0	1
kmgr	https://github.com/kmgr	1	0	0	1
knsd	https://github.com/knsd	0	2	0	2
kuss	https://github.com/kuss	3	0	0	3
l1m5	https://github.com/l1m5	2	0	0	2
leon	https://github.com/leon	1	0	0	1
lieb	https://github.com/lieb	0	1	0	1
louh	https://github.com/louh	1	2	0	3
lvca	https://github.com/lvca	1	2	1	4
m1kc	https://github.com/m1kc	6	1	0	7
mabl	https://github.com/mabl	0	1	0	1
maca	https://github.com/maca	1	0	0	1
maxf	https://github.com/maxf	1	0	0	1
mbax	https://github.com/mbax	0	1	0	1
mck-	https://github.com/mck-	2	0	0	2
md-5	https://github.com/md-5	0	3	0	3
mhvk	https://github.com/mhvk	1	1	0	2
miah	https://github.com/miah	0	2	0	2
mixu	https://github.com/mixu	0	1	0	1
mllg	https://github.com/mllg	1	0	0	1
moll	https://github.com/moll	1	0	0	1
mrli	https://github.com/mrli	2	0	0	2
muga	https://github.com/muga	0	1	0	1
n-kb	https://github.com/n-kb	1	2	0	3
n1k0	https://github.com/n1k0	0	1	0	1
nafg	https://github.com/nafg	1	0	0	1
nbmc	https://github.com/nbmc	0	1	0	1
nfrm	https://github.com/nfrm	1	0	0	1
nfx9	https://github.com/nfx9	1	0	0	1
niko	https://github.com/niko	1	0	0	1
nrdt	https://github.com/nrdt	1	0	0	1
okor	https://github.com/okor	1	0	0	1
orta	https://github.com/orta	0	1	0	1
oz42	https://github.com/oz42	1	0	0	1
peti	https://github.com/peti	0	1	0	1
pftg	https://github.com/pftg	2	0	0	2
pote	https://github.com/pote	0	1	0	1
ptia	https://github.com/ptia	0	1	0	1
pvdl	https://github.com/pvdl	1	0	0	1
qfox	https://github.com/qfox	1	0	0	1
r38y	https://github.com/r38y	1	0	0	1
rair	https://github.com/rair	1	0	0	1
raix	https://github.com/raix	1	0	0	1
relf	https://github.com/relf	0	2	0	2
relu	https://github.com/relu	1	0	0	1
rfay	https://github.com/rfay	0	1	0	1
rgov	https://github.com/rgov	4	0	0	4
rhsu	https://github.com/rhsu	1	0	0	1
rjbs	https://github.com/rjbs	1	0	0	1
rlux	https://github.com/rlux	1	0	0	1
rmsy	https://github.com/rmsy	0	1	0	1
rolk	https://github.com/rolk	1	0	0	1
rpav	https://github.com/rpav	0	3	0	3
runk	https://github.com/runk	0	1	0	1
shk3	https://github.com/shk3	0	1	0	1
sime	https://github.com/sime	0	1	0	1
siso	https://github.com/siso	0	1	0	1
snej	https://github.com/snej	0	1	0	1
snwh	https://github.com/snwh	0	0	1	1
sqmk	https://github.com/sqmk	0	1	0	1
stil	https://github.com/stil	0	1	0	1
stof	https://github.com/stof	0	1	0	1
strk	https://github.com/strk	2	2	0	4
susu	https://github.com/susu	1	0	0	1
t4k4	https://github.com/t4k4	1	2	0	3
tb38	https://github.com/tb38	0	1	0	1
thet	https://github.com/thet	0	1	1	2
till	https://github.com/till	1	0	0	1
tlau	https://github.com/tlau	11	0	0	11
tmcw	https://github.com/tmcw	11	6	0	17
toah	https://github.com/toah	1	0	0	1
troy	https://github.com/troy	0	1	0	1
ttk2	https://github.com/ttk2	1	0	0	1
unho	https://github.com/unho	3	0	0	3
urdh	https://github.com/urdh	1	3	0	4
wawe	https://github.com/wawe	0	1	0	1
wmds	https://github.com/wmds	0	2	0	2
worr	https://github.com/worr	3	1	0	4
wuub	https://github.com/wuub	0	1	0	1
wuzh	https://github.com/wuzh	1	0	0	1
xZWL	https://github.com/xZWL	1	0	0	1
xiam	https://github.com/xiam	0	1	0	1
xpol	https://github.com/xpol	1	0	0	1
yaph	https://github.com/yaph	2	3	0	5
ylow	https://github.com/ylow	0	1	0	1
zpao	https://github.com/zpao	1	1	0	2
0wing	https://github.com/0wing	0	1	0	1
0xor1	https://github.com/0xor1	2	0	0	2
4lt4i	https://github.com/4lt4i	0	1	0	1
73ddy	https://github.com/73ddy	5	3	0	8
88250	https://github.com/88250	1	0	0	1
Acidy	https://github.com/Acidy	1	0	0	1
AliMD	https://github.com/AliMD	1	0	0	1
Arul-	https://github.com/Arul-	0	1	0	1
Athou	https://github.com/Athou	0	1	0	1
Azer-	https://github.com/Azer-	1	0	0	1
Bakro	https://github.com/Bakro	1	0	0	1
BobMP	https://github.com/BobMP	1	0	0	1
Bwavy	https://github.com/Bwavy	1	0	0	1
Cbeed	https://github.com/Cbeed	1	2	0	3
CiGit	https://github.com/CiGit	1	1	1	3
Cmptr	https://github.com/Cmptr	2	0	0	2
DAlOG	https://github.com/DAlOG	1	0	0	1
Dany0	https://github.com/Dany0	1	0	0	1
Digit	https://github.com/Digit	1	0	0	1
DirkR	https://github.com/DirkR	1	0	0	1
DjAnu	https://github.com/DjAnu	1	0	0	1
DyaGa	https://github.com/DyaGa	1	0	0	1
Edhen	https://github.com/Edhen	1	0	0	1
Eeems	https://github.com/Eeems	0	5	0	5
Enkil	https://github.com/Enkil	1	0	0	1
Fjury	https://github.com/Fjury	1	0	0	1
Flimm	https://github.com/Flimm	1	0	0	1
Groxx	https://github.com/Groxx	1	0	0	1
Havvy	https://github.com/Havvy	1	0	0	1
Hekta	https://github.com/Hekta	2	0	0	2
Hibby	https://github.com/Hibby	1	0	0	1
Izzmo	https://github.com/Izzmo	0	1	0	1
JESii	https://github.com/JESii	1	0	0	1
Jaans	https://github.com/Jaans	1	0	0	1
JinTu	https://github.com/JinTu	0	1	0	1
Kiszh	https://github.com/Kiszh	1	0	0	1
KyraD	https://github.com/KyraD	0	1	0	1
MKLau	https://github.com/MKLau	36	0	0	36
MacKP	https://github.com/MacKP	2	1	0	3
Malet	https://github.com/Malet	1	0	0	1
Mauop	https://github.com/Mauop	1	0	0	1
NStal	https://github.com/NStal	1	1	0	2
Nanai	https://github.com/Nanai	1	0	0	1
Nek80	https://github.com/Nek80	1	0	0	1
Nuand	https://github.com/Nuand	0	1	0	1
Orkin	https://github.com/Orkin	0	1	0	1
PDN04	https://github.com/PDN04	4	0	0	4
Palmr	https://github.com/Palmr	0	2	0	2
Paris	https://github.com/Paris	0	2	0	2
Pomax	https://github.com/Pomax	2	2	0	4
Pross	https://github.com/Pross	0	1	0	1
RhysU	https://github.com/RhysU	1	0	0	1
Ruudt	https://github.com/Ruudt	1	0	0	1
ScenK	https://github.com/ScenK	2	0	0	2
Sciss	https://github.com/Sciss	2	0	0	2
SebyM	https://github.com/SebyM	1	0	0	1
Sibyx	https://github.com/Sibyx	0	1	0	1
Snowl	https://github.com/Snowl	0	1	0	1
Souto	https://github.com/Souto	1	1	0	2
Sparo	https://github.com/Sparo	1	0	0	1
Tapsi	https://github.com/Tapsi	0	1	0	1
Timer	https://github.com/Timer	0	1	0	1
ToksT	https://github.com/ToksT	2	1	0	3
TomMD	https://github.com/TomMD	1	1	0	2
Trott	https://github.com/Trott	2	0	0	2
Vinai	https://github.com/Vinai	0	1	0	1
Wilmo	https://github.com/Wilmo	1	1	0	2
WoLpH	https://github.com/WoLpH	4	1	0	5
XPJ38	https://github.com/XPJ38	1	0	0	1
Xuhao	https://github.com/Xuhao	0	1	0	1
Zarel	https://github.com/Zarel	0	1	0	1
ZhukV	https://github.com/ZhukV	1	0	0	1
Znote	https://github.com/Znote	0	1	0	1
a-tux	https://github.com/a-tux	3	0	0	3
abrkn	https://github.com/abrkn	2	4	0	6
abyte	https://github.com/abyte	1	0	0	1
acgti	https://github.com/acgti	1	0	0	1
achan	https://github.com/achan	3	3	0	6
adamv	https://github.com/adamv	0	8	0	8
adick	https://github.com/adick	1	0	0	1
aebsr	https://github.com/aebsr	1	0	0	1
agune	https://github.com/agune	0	2	0	2
ahinz	https://github.com/ahinz	2	11	0	13
ahorn	https://github.com/ahorn	0	1	0	1
aivuk	https://github.com/aivuk	0	2	0	2
ajgon	https://github.com/ajgon	8	5	0	13
akhil	https://github.com/akhil	1	0	0	1
alanz	https://github.com/alanz	1	0	0	1
alice	https://github.com/alice	1	0	0	1
alloy	https://github.com/alloy	0	1	0	1
alrra	https://github.com/alrra	1	1	0	2
amenk	https://github.com/amenk	2	0	0	2
amol-	https://github.com/amol-	0	2	0	2
amxku	https://github.com/amxku	1	0	0	1
andjo	https://github.com/andjo	1	0	0	1
antda	https://github.com/antda	1	1	0	2
aplib	https://github.com/aplib	5	1	0	6
aranw	https://github.com/aranw	1	0	0	1
arnoo	https://github.com/arnoo	0	1	0	1
arski	https://github.com/arski	0	1	0	1
asm89	https://github.com/asm89	0	1	0	1
atans	https://github.com/atans	1	0	0	1
atnnn	https://github.com/atnnn	0	1	0	1
avanc	https://github.com/avanc	1	0	0	1
awead	https://github.com/awead	1	1	0	2
awick	https://github.com/awick	0	1	0	1
balat	https://github.com/balat	0	1	0	1
bas-t	https://github.com/bas-t	0	1	0	1
basvd	https://github.com/basvd	1	0	0	1
bdeak	https://github.com/bdeak	1	0	0	1
bekos	https://github.com/bekos	0	1	0	1
bencz	https://github.com/bencz	1	1	0	2
bezda	https://github.com/bezda	1	0	0	1
bguiz	https://github.com/bguiz	1	0	0	1
birko	https://github.com/birko	1	0	0	1
bkolb	https://github.com/bkolb	1	0	0	1
bkuhl	https://github.com/bkuhl	2	0	0	2
bl1nk	https://github.com/bl1nk	1	0	0	1
bling	https://github.com/bling	0	3	1	4
bliti	https://github.com/bliti	0	1	0	1
blitz	https://github.com/blitz	2	0	0	2
bluca	https://github.com/bluca	1	0	0	1
boboz	https://github.com/boboz	1	0	0	1
breun	https://github.com/breun	1	0	0	1
bruth	https://github.com/bruth	1	2	0	3
bsima	https://github.com/bsima	1	1	0	2
bukka	https://github.com/bukka	0	1	0	1
bwl21	https://github.com/bwl21	1	0	0	1
c4d3r	https://github.com/c4d3r	0	1	0	1
calmh	https://github.com/calmh	1	0	0	1
cchou	https://github.com/cchou	0	2	0	2
chelm	https://github.com/chelm	0	2	0	2
chewi	https://github.com/chewi	0	1	0	1
chovy	https://github.com/chovy	1	0	0	1
ckrey	https://github.com/ckrey	0	1	0	1
claar	https://github.com/claar	1	0	0	1
clamz	https://github.com/clamz	2	0	0	2
claxo	https://github.com/claxo	1	0	0	1
claym	https://github.com/claym	1	0	0	1
clkao	https://github.com/clkao	2	2	0	4
cobub	https://github.com/cobub	0	1	0	1
coopr	https://github.com/coopr	1	0	0	1
crc83	https://github.com/crc83	2	2	0	4
csaez	https://github.com/csaez	1	0	0	1
csete	https://github.com/csete	0	1	0	1
cubiq	https://github.com/cubiq	0	2	0	2
cxong	https://github.com/cxong	0	2	0	2
cxwxz	https://github.com/cxwxz	1	0	0	1
daeks	https://github.com/daeks	0	1	0	1
daffl	https://github.com/daffl	1	0	0	1
daggs	https://github.com/daggs	1	0	0	1
dahlb	https://github.com/dahlb	1	0	0	1
dalph	https://github.com/dalph	1	0	0	1
daonb	https://github.com/daonb	1	2	0	3
dazld	https://github.com/dazld	1	0	0	1
dbent	https://github.com/dbent	2	0	0	2
dbubs	https://github.com/dbubs	0	1	0	1
def87	https://github.com/def87	1	0	0	1
deiga	https://github.com/deiga	1	0	0	1
dfang	https://github.com/dfang	1	0	0	1
dhsto	https://github.com/dhsto	1	0	0	1
dhura	https://github.com/dhura	0	1	1	2
disdi	https://github.com/disdi	2	0	0	2
diyan	https://github.com/diyan	0	1	0	1
djs55	https://github.com/djs55	1	0	0	1
dlang	https://github.com/dlang	1	0	0	1
dotta	https://github.com/dotta	1	0	0	1
dougt	https://github.com/dougt	1	0	0	1
dreid	https://github.com/dreid	1	0	0	1
dridk	https://github.com/dridk	3	1	0	4
drj11	https://github.com/drj11	0	1	0	1
drnic	https://github.com/drnic	2	0	0	2
dsk2k	https://github.com/dsk2k	1	0	0	1
dtopn	https://github.com/dtopn	1	0	0	1
dwins	https://github.com/dwins	1	0	0	1
dzmen	https://github.com/dzmen	1	0	0	1
e-gor	https://github.com/e-gor	2	3	0	5
eages	https://github.com/eages	0	1	0	1
eah13	https://github.com/eah13	0	1	0	1
eater	https://github.com/eater	1	0	0	1
ebr11	https://github.com/ebr11	0	1	0	1
edsko	https://github.com/edsko	1	0	0	1
ekwus	https://github.com/ekwus	1	0	0	1
ellhn	https://github.com/ellhn	2	0	0	2
epeli	https://github.com/epeli	0	2	0	2
ericf	https://github.com/ericf	0	2	0	2
erikr	https://github.com/erikr	1	0	0	1
ernie	https://github.com/ernie	0	1	0	1
erocs	https://github.com/erocs	0	2	0	2
esmet	https://github.com/esmet	3	1	0	4
etlds	https://github.com/etlds	2	0	0	2
evanp	https://github.com/evanp	1	0	0	1
falzm	https://github.com/falzm	1	0	0	1
felly	https://github.com/felly	1	0	0	1
fjies	https://github.com/fjies	1	0	0	1
fredj	https://github.com/fredj	2	3	0	5
fserb	https://github.com/fserb	1	0	0	1
fwolf	https://github.com/fwolf	1	0	0	1
gali8	https://github.com/gali8	0	1	0	1
gamab	https://github.com/gamab	0	1	0	1
gawry	https://github.com/gawry	1	0	0	1
gedex	https://github.com/gedex	1	0	0	1
gehan	https://github.com/gehan	1	0	0	1
gener	https://github.com/gener	1	0	0	1
geoom	https://github.com/geoom	1	0	0	1
ggrin	https://github.com/ggrin	0	1	0	1
ghing	https://github.com/ghing	0	1	0	1
gidsg	https://github.com/gidsg	1	0	0	1
gnott	https://github.com/gnott	1	0	0	1
grasn	https://github.com/grasn	1	0	0	1
gregf	https://github.com/gregf	1	0	0	1
guyer	https://github.com/guyer	1	0	0	1
haggi	https://github.com/haggi	4	6	0	10
haslo	https://github.com/haslo	9	0	0	9
headi	https://github.com/headi	0	1	0	1
henix	https://github.com/henix	1	0	0	1
herby	https://github.com/herby	1	4	0	5
hmeza	https://github.com/hmeza	1	0	0	1
holms	https://github.com/holms	1	0	0	1
horte	https://github.com/horte	0	0	1	1
houzy	https://github.com/houzy	1	0	0	1
hubsw	https://github.com/hubsw	1	0	0	1
hujin	https://github.com/hujin	1	0	0	1
huntc	https://github.com/huntc	0	3	0	3
huonw	https://github.com/huonw	1	0	0	1
huoxy	https://github.com/huoxy	1	0	0	1
ibuck	https://github.com/ibuck	1	0	0	1
icbat	https://github.com/icbat	2	0	0	2
icook	https://github.com/icook	0	1	0	1
idevk	https://github.com/idevk	1	0	0	1
idoru	https://github.com/idoru	0	1	0	1
igrep	https://github.com/igrep	1	0	0	1
iku19	https://github.com/iku19	1	0	0	1
ingee	https://github.com/ingee	0	4	0	4
ingwa	https://github.com/ingwa	0	1	0	1
inodb	https://github.com/inodb	0	1	0	1
iplog	https://github.com/iplog	1	0	0	1
itang	https://github.com/itang	1	0	0	1
ivdok	https://github.com/ivdok	0	0	1	1
ivern	https://github.com/ivern	1	0	0	1
ivolo	https://github.com/ivolo	1	0	0	1
jam13	https://github.com/jam13	0	1	0	1
janot	https://github.com/janot	1	0	0	1
jarib	https://github.com/jarib	2	0	0	2
jboho	https://github.com/jboho	12	0	0	12
jcran	https://github.com/jcran	1	0	0	1
jean1	https://github.com/jean1	0	1	0	1
jedax	https://github.com/jedax	1	0	0	1
jeena	https://github.com/jeena	1	12	0	13
jfine	https://github.com/jfine	0	1	1	2
jgoat	https://github.com/jgoat	1	0	0	1
jinzw	https://github.com/jinzw	2	4	0	6
jjccc	https://github.com/jjccc	3	3	0	6
jlord	https://github.com/jlord	1	0	0	1
jlyon	https://github.com/jlyon	1	0	0	1
jnewc	https://github.com/jnewc	1	0	0	1
joeyh	https://github.com/joeyh	1	0	0	1
jooag	https://github.com/jooag	1	0	0	1
jroed	https://github.com/jroed	0	1	0	1
jusio	https://github.com/jusio	2	0	0	2
jvelo	https://github.com/jvelo	1	1	0	2
jyli7	https://github.com/jyli7	4	3	0	7
jzeta	https://github.com/jzeta	2	1	0	3
k-rus	https://github.com/k-rus	6	4	1	11
k0001	https://github.com/k0001	1	1	0	2
k00ni	https://github.com/k00ni	0	2	0	2
kYc0o	https://github.com/kYc0o	1	0	0	1
ka223	https://github.com/ka223	1	0	0	1
ka2er	https://github.com/ka2er	1	0	0	1
kaero	https://github.com/kaero	1	5	0	6
kahrl	https://github.com/kahrl	0	3	0	3
kaiks	https://github.com/kaiks	3	0	0	3
kasea	https://github.com/kasea	1	0	0	1
kdavy	https://github.com/kdavy	1	0	0	1
kener	https://github.com/kener	0	2	0	2
kengu	https://github.com/kengu	1	0	0	1
kguil	https://github.com/kguil	0	2	0	2
khong	https://github.com/khong	1	0	0	1
kjdav	https://github.com/kjdav	1	1	0	2
kmeht	https://github.com/kmeht	1	1	0	2
kmike	https://github.com/kmike	0	1	0	1
knoff	https://github.com/knoff	1	0	0	1
komby	https://github.com/komby	1	0	0	1
koush	https://github.com/koush	0	1	0	1
kueda	https://github.com/kueda	1	1	0	2
kvnco	https://github.com/kvnco	5	0	0	5
lahma	https://github.com/lahma	1	2	0	3
le717	https://github.com/le717	0	1	0	1
lfryc	https://github.com/lfryc	1	0	0	1
llbit	https://github.com/llbit	1	1	0	2
llddy	https://github.com/llddy	1	0	0	1
lsgro	https://github.com/lsgro	1	2	0	3
luite	https://github.com/luite	5	3	0	8
lushc	https://github.com/lushc	2	0	0	2
mDiyo	https://github.com/mDiyo	2	0	0	2
mahgo	https://github.com/mahgo	1	0	0	1
majek	https://github.com/majek	1	1	0	2
malaa	https://github.com/malaa	1	0	0	1
malev	https://github.com/malev	1	0	0	1
malko	https://github.com/malko	1	0	0	1
matao	https://github.com/matao	8	1	0	9
matco	https://github.com/matco	1	0	0	1
mattt	https://github.com/mattt	0	1	0	1
max-m	https://github.com/max-m	1	0	0	1
mbark	https://github.com/mbark	1	0	0	1
meee1	https://github.com/meee1	0	3	0	3
mekya	https://github.com/mekya	2	0	0	2
meyla	https://github.com/meyla	1	0	0	1
mhald	https://github.com/mhald	1	0	0	1
micah	https://github.com/micah	1	1	0	2
michg	https://github.com/michg	2	0	0	2
mitar	https://github.com/mitar	2	0	0	2
mitio	https://github.com/mitio	1	0	0	1
mitom	https://github.com/mitom	3	0	0	3
mosra	https://github.com/mosra	0	1	0	1
motib	https://github.com/motib	1	0	0	1
mraof	https://github.com/mraof	0	1	0	1
mrjbg	https://github.com/mrjbg	1	0	0	1
mroth	https://github.com/mroth	0	1	0	1
mrshu	https://github.com/mrshu	0	1	0	1
mtodd	https://github.com/mtodd	8	0	0	8
mvdan	https://github.com/mvdan	1	0	0	1
mxmcc	https://github.com/mxmcc	1	0	0	1
myint	https://github.com/myint	0	1	0	1
mzgol	https://github.com/mzgol	1	0	0	1
naoro	https://github.com/naoro	1	0	0	1
nfoti	https://github.com/nfoti	1	0	0	1
nielk	https://github.com/nielk	1	0	0	1
nogar	https://github.com/nogar	3	0	0	3
nomed	https://github.com/nomed	1	0	0	1
noxx2	https://github.com/noxx2	1	0	0	1
nsina	https://github.com/nsina	1	0	0	1
ntasi	https://github.com/ntasi	1	0	0	1
ocram	https://github.com/ocram	0	3	0	3
oddui	https://github.com/oddui	1	0	0	1
oh240	https://github.com/oh240	2	0	0	2
okize	https://github.com/okize	2	1	0	3
okram	https://github.com/okram	0	1	0	1
opike	https://github.com/opike	1	0	0	1
oryxn	https://github.com/oryxn	1	0	0	1
oster	https://github.com/oster	2	0	0	2
ottob	https://github.com/ottob	2	1	0	3
oz123	https://github.com/oz123	0	1	1	2
ozcar	https://github.com/ozcar	1	0	0	1
p-e-w	https://github.com/p-e-w	0	1	0	1
p0nce	https://github.com/p0nce	3	0	0	3
palli	https://github.com/palli	0	1	0	1
parke	https://github.com/parke	1	0	0	1
parkr	https://github.com/parkr	0	1	0	1
pavel	https://github.com/pavel	1	1	0	2
pe3zx	https://github.com/pe3zx	1	0	0	1
pfitz	https://github.com/pfitz	1	1	0	2
phstc	https://github.com/phstc	1	0	0	1
ponty	https://github.com/ponty	0	1	0	1
pvaut	https://github.com/pvaut	1	0	0	1
pw374	https://github.com/pw374	0	1	0	1
pyrog	https://github.com/pyrog	2	0	0	2
qszhu	https://github.com/qszhu	1	0	0	1
quyse	https://github.com/quyse	0	1	0	1
racke	https://github.com/racke	0	1	0	1
radar	https://github.com/radar	0	6	3	9
radev	https://github.com/radev	1	0	0	1
rahoc	https://github.com/rahoc	2	15	0	17
raimi	https://github.com/raimi	2	0	0	2
rande	https://github.com/rande	0	2	0	2
ranm8	https://github.com/ranm8	0	1	0	1
remik	https://github.com/remik	1	0	0	1
reset	https://github.com/reset	0	1	0	1
retro	https://github.com/retro	1	0	0	1
reyro	https://github.com/reyro	1	0	0	1
rezzo	https://github.com/rezzo	0	1	0	1
rhoit	https://github.com/rhoit	0	1	0	1
richo	https://github.com/richo	1	0	0	1
rienq	https://github.com/rienq	0	1	0	1
rikai	https://github.com/rikai	2	1	0	3
rolfn	https://github.com/rolfn	1	0	0	1
rreyv	https://github.com/rreyv	3	0	0	3
russl	https://github.com/russl	1	0	0	1
rvagg	https://github.com/rvagg	0	3	0	3
rymai	https://github.com/rymai	0	2	0	2
s-m-k	https://github.com/s-m-k	1	0	0	1
salgo	https://github.com/salgo	0	1	0	1
sapfo	https://github.com/sapfo	7	1	0	8
satta	https://github.com/satta	0	1	0	1
sbspk	https://github.com/sbspk	0	5	1	6
seanh	https://github.com/seanh	1	2	0	3
ser72	https://github.com/ser72	1	0	0	1
setek	https://github.com/setek	1	0	0	1
sfpuc	https://github.com/sfpuc	1	0	0	1
shaih	https://github.com/shaih	0	1	1	2
shama	https://github.com/shama	0	3	0	3
shatl	https://github.com/shatl	1	0	0	1
shin-	https://github.com/shin-	0	1	0	1
shish	https://github.com/shish	1	0	0	1
sidro	https://github.com/sidro	0	1	0	1
sihil	https://github.com/sihil	1	0	0	1
sivel	https://github.com/sivel	1	0	0	1
sj4nz	https://github.com/sj4nz	1	0	0	1
sjlee	https://github.com/sjlee	1	1	0	2
skddc	https://github.com/skddc	1	0	0	1
skoji	https://github.com/skoji	2	0	0	2
slara	https://github.com/slara	0	1	0	1
smits	https://github.com/smits	1	0	0	1
smola	https://github.com/smola	2	0	0	2
sopel	https://github.com/sopel	1	1	0	2
sotte	https://github.com/sotte	0	1	0	1
spolu	https://github.com/spolu	2	3	0	5
srish	https://github.com/srish	1	0	0	1
srt32	https://github.com/srt32	0	2	0	2
ssull	https://github.com/ssull	1	0	0	1
stocc	https://github.com/stocc	1	0	0	1
sudar	https://github.com/sudar	2	4	0	6
sugyo	https://github.com/sugyo	1	1	0	2
sylus	https://github.com/sylus	0	10	0	10
tD3rk	https://github.com/tD3rk	1	0	0	1
tanhs	https://github.com/tanhs	1	0	0	1
tario	https://github.com/tario	1	1	0	2
tcooc	https://github.com/tcooc	0	1	0	1
tdtds	https://github.com/tdtds	0	0	1	1
tekko	https://github.com/tekko	1	0	0	1
thans	https://github.com/thans	0	1	0	1
theod	https://github.com/theod	0	1	0	1
thobe	https://github.com/thobe	1	0	0	1
tibbe	https://github.com/tibbe	3	1	0	4
tikue	https://github.com/tikue	0	1	0	1
timmc	https://github.com/timmc	1	0	0	1
tiste	https://github.com/tiste	1	0	0	1
tobie	https://github.com/tobie	1	6	0	7
tonio	https://github.com/tonio	0	1	0	1
tooru	https://github.com/tooru	1	0	0	1
toots	https://github.com/toots	0	1	0	1
tpope	https://github.com/tpope	0	4	0	4
trink	https://github.com/trink	2	2	0	4
tvn87	https://github.com/tvn87	1	2	0	3
twinh	https://github.com/twinh	1	0	0	1
twoer	https://github.com/twoer	1	0	0	1
tych0	https://github.com/tych0	1	1	0	2
u6c00	https://github.com/u6c00	2	0	0	2
umaar	https://github.com/umaar	1	0	0	1
unbit	https://github.com/unbit	0	1	0	1
unogz	https://github.com/unogz	2	2	0	4
utz82	https://github.com/utz82	1	2	0	3
vadi2	https://github.com/vadi2	0	1	0	1
vargi	https://github.com/vargi	1	0	0	1
vemec	https://github.com/vemec	1	1	0	2
vidma	https://github.com/vidma	4	4	0	8
vpeil	https://github.com/vpeil	1	0	0	1
w1lla	https://github.com/w1lla	1	0	0	1
wbond	https://github.com/wbond	1	1	0	2
winko	https://github.com/winko	1	0	0	1
wking	https://github.com/wking	0	2	0	2
xCuDi	https://github.com/xCuDi	1	0	0	1
xHire	https://github.com/xHire	1	0	0	1
xaprb	https://github.com/xaprb	0	1	0	1
xbeta	https://github.com/xbeta	1	0	0	1
xhava	https://github.com/xhava	1	0	0	1
xihui	https://github.com/xihui	2	0	0	2
y-ken	https://github.com/y-ken	0	1	0	1
yakky	https://github.com/yakky	0	1	0	1
yetti	https://github.com/yetti	3	2	1	6
yjung	https://github.com/yjung	0	3	0	3
ykzts	https://github.com/ykzts	2	0	0	2
zaher	https://github.com/zaher	2	2	0	4
zappn	https://github.com/zappn	1	1	0	2
zaufi	https://github.com/zaufi	0	1	0	1
zimok	https://github.com/zimok	1	0	0	1
zivee	https://github.com/zivee	1	0	0	1
zocky	https://github.com/zocky	1	1	0	2
zozoh	https://github.com/zozoh	0	1	0	1
zycet	https://github.com/zycet	1	0	0	1
4rthem	https://github.com/4rthem	1	0	0	1
876974	https://github.com/876974	1	0	0	1
AD7six	https://github.com/AD7six	0	1	0	1
AMDmi3	https://github.com/AMDmi3	1	1	1	3
ARNHOE	https://github.com/ARNHOE	1	0	0	1
Abbe98	https://github.com/Abbe98	1	0	0	1
AdamN1	https://github.com/AdamN1	1	0	0	1
Adubbz	https://github.com/Adubbz	0	1	0	1
Algent	https://github.com/Algent	2	0	0	2
ArtisR	https://github.com/ArtisR	1	0	0	1
Asenar	https://github.com/Asenar	1	0	0	1
Atinux	https://github.com/Atinux	0	1	0	1
Bailei	https://github.com/Bailei	1	0	0	1
BenJam	https://github.com/BenJam	0	1	0	1
Bilalh	https://github.com/Bilalh	0	1	0	1
Bjwebb	https://github.com/Bjwebb	2	1	0	3
BlixLT	https://github.com/BlixLT	2	0	0	2
Bronsa	https://github.com/Bronsa	1	0	0	1
Buttyx	https://github.com/Buttyx	0	1	0	1
CMDann	https://github.com/CMDann	1	0	0	1
Cacauu	https://github.com/Cacauu	0	2	0	2
Carino	https://github.com/Carino	1	0	0	1
Carxus	https://github.com/Carxus	1	0	0	1
Ceasar	https://github.com/Ceasar	0	3	0	3
D-Roch	https://github.com/D-Roch	30	1	0	31
DTrejo	https://github.com/DTrejo	1	0	0	1
DaNiwa	https://github.com/DaNiwa	1	1	0	2
Dayver	https://github.com/Dayver	0	1	0	1
DevanB	https://github.com/DevanB	1	1	1	3
Dokman	https://github.com/Dokman	1	0	0	1
DrNixx	https://github.com/DrNixx	1	0	0	1
Drarok	https://github.com/Drarok	1	0	0	1
EduSec	https://github.com/EduSec	0	1	0	1
Elmari	https://github.com/Elmari	1	0	0	1
Enelar	https://github.com/Enelar	1	1	0	2
EricGT	https://github.com/EricGT	1	0	0	1
Eugeny	https://github.com/Eugeny	0	2	0	2
Evropi	https://github.com/Evropi	1	0	0	1
FMCorz	https://github.com/FMCorz	0	3	0	3
Farges	https://github.com/Farges	1	0	0	1
Floppy	https://github.com/Floppy	3	1	0	4
Flow86	https://github.com/Flow86	1	0	0	1
Flupsy	https://github.com/Flupsy	1	0	0	1
Gaubee	https://github.com/Gaubee	1	0	0	1
Godimy	https://github.com/Godimy	1	0	0	1
Gurben	https://github.com/Gurben	1	0	0	1
Habbie	https://github.com/Habbie	1	6	0	7
HaronK	https://github.com/HaronK	1	0	0	1
JISyed	https://github.com/JISyed	0	1	0	1
Jacold	https://github.com/Jacold	1	0	0	1
Jonhoo	https://github.com/Jonhoo	0	1	0	1
Kakadu	https://github.com/Kakadu	1	0	0	1
Kauhsa	https://github.com/Kauhsa	1	0	0	1
KenanY	https://github.com/KenanY	1	0	0	1
Kichaa	https://github.com/Kichaa	1	0	0	1
KoFish	https://github.com/KoFish	4	5	0	9
Koenkk	https://github.com/Koenkk	0	1	0	1
Lemmih	https://github.com/Lemmih	0	3	0	3
Leorra	https://github.com/Leorra	1	0	0	1
Linyor	https://github.com/Linyor	1	0	0	1
Livian	https://github.com/Livian	1	0	0	1
MalteJ	https://github.com/MalteJ	1	0	0	1
Marsup	https://github.com/Marsup	1	0	0	1
MaxMad	https://github.com/MaxMad	1	0	0	1
McGern	https://github.com/McGern	1	0	0	1
Morgul	https://github.com/Morgul	2	0	0	2
Ms2ger	https://github.com/Ms2ger	1	0	0	1
NMTuan	https://github.com/NMTuan	1	0	0	1
NanoXD	https://github.com/NanoXD	0	1	0	1
Narigo	https://github.com/Narigo	0	1	0	1
Nebual	https://github.com/Nebual	0	2	0	2
Necoro	https://github.com/Necoro	1	0	0	1
NimoII	https://github.com/NimoII	1	1	0	2
Nogbit	https://github.com/Nogbit	1	0	0	1
Ogimle	https://github.com/Ogimle	1	0	0	1
PDXIII	https://github.com/PDXIII	2	0	0	2
PaulVI	https://github.com/PaulVI	1	0	0	1
Pestov	https://github.com/Pestov	1	0	0	1
Phipsz	https://github.com/Phipsz	1	0	0	1
Pickra	https://github.com/Pickra	1	0	0	1
Po-Jen	https://github.com/Po-Jen	1	0	0	1
Qtxlol	https://github.com/Qtxlol	1	0	0	1
Ragnis	https://github.com/Ragnis	0	1	0	1
Raynes	https://github.com/Raynes	0	1	0	1
Raynos	https://github.com/Raynos	3	0	0	3
Razer6	https://github.com/Razer6	0	1	0	1
RedOrm	https://github.com/RedOrm	1	1	0	2
RichiH	https://github.com/RichiH	1	0	0	1
Robby-	https://github.com/Robby-	1	0	0	1
RubaXa	https://github.com/RubaXa	0	1	0	1
Rup0rt	https://github.com/Rup0rt	0	1	0	1
Sereri	https://github.com/Sereri	0	1	0	1
Shougo	https://github.com/Shougo	0	3	0	3
Srokap	https://github.com/Srokap	1	0	0	1
SunboX	https://github.com/SunboX	1	1	0	2
TTbots	https://github.com/TTbots	1	0	0	1
Tarig0	https://github.com/Tarig0	5	0	0	5
Tekhne	https://github.com/Tekhne	1	0	0	1
TfT-02	https://github.com/TfT-02	1	2	0	3
Timtam	https://github.com/Timtam	4	0	0	4
Toflar	https://github.com/Toflar	0	3	0	3
TomOne	https://github.com/TomOne	1	0	0	1
UXDart	https://github.com/UXDart	1	0	0	1
Vality	https://github.com/Vality	1	0	0	1
Volune	https://github.com/Volune	1	0	0	1
Wasala	https://github.com/Wasala	1	0	0	1
Wessix	https://github.com/Wessix	1	0	0	1
Zaraka	https://github.com/Zaraka	1	0	0	1
Zhiran	https://github.com/Zhiran	2	0	0	2
a0r1an	https://github.com/a0r1an	1	0	0	1
aBuder	https://github.com/aBuder	1	0	0	1
aagbsn	https://github.com/aagbsn	1	0	0	1
abayer	https://github.com/abayer	0	1	0	1
abbood	https://github.com/abbood	1	0	0	1
abbyad	https://github.com/abbyad	4	0	0	4
achalv	https://github.com/achalv	1	0	0	1
acosta	https://github.com/acosta	1	1	0	2
acouch	https://github.com/acouch	2	1	0	3
acsnem	https://github.com/acsnem	1	0	0	1
acstll	https://github.com/acstll	2	0	0	2
adam-p	https://github.com/adam-p	0	1	0	1
adepue	https://github.com/adepue	0	1	0	1
adrpar	https://github.com/adrpar	0	1	0	1
afc163	https://github.com/afc163	1	0	0	1
affan2	https://github.com/affan2	1	0	0	1
agouge	https://github.com/agouge	0	2	0	2
agrimm	https://github.com/agrimm	1	0	0	1
agross	https://github.com/agross	0	1	0	1
akberc	https://github.com/akberc	1	0	0	1
alabid	https://github.com/alabid	0	2	0	2
alanxz	https://github.com/alanxz	0	1	0	1
alarcl	https://github.com/alarcl	1	0	0	1
albi90	https://github.com/albi90	1	0	0	1
alnsnk	https://github.com/alnsnk	1	1	1	3
alycit	https://github.com/alycit	1	0	0	1
alykat	https://github.com/alykat	1	0	0	1
amagan	https://github.com/amagan	0	1	0	1
amattn	https://github.com/amattn	1	1	0	2
amluto	https://github.com/amluto	1	0	0	1
andwah	https://github.com/andwah	2	0	0	2
anobre	https://github.com/anobre	0	1	1	2
antage	https://github.com/antage	0	1	0	1
anurse	https://github.com/anurse	0	2	0	2
anzexu	https://github.com/anzexu	3	5	0	8
apuyou	https://github.com/apuyou	2	1	0	3
areski	https://github.com/areski	0	2	0	2
armooo	https://github.com/armooo	0	3	0	3
arnav7	https://github.com/arnav7	1	0	0	1
arno34	https://github.com/arno34	3	0	0	3
arodic	https://github.com/arodic	1	1	0	2
arr-ee	https://github.com/arr-ee	1	0	0	1
arruda	https://github.com/arruda	9	0	0	9
asikec	https://github.com/asikec	1	0	0	1
asouza	https://github.com/asouza	2	0	0	2
ateska	https://github.com/ateska	3	2	0	5
atupal	https://github.com/atupal	1	0	0	1
aurmil	https://github.com/aurmil	0	1	0	1
avanov	https://github.com/avanov	2	1	0	3
avs262	https://github.com/avs262	1	0	0	1
axlekb	https://github.com/axlekb	2	0	0	2
azakus	https://github.com/azakus	2	2	0	4
badhex	https://github.com/badhex	0	1	0	1
bala-v	https://github.com/bala-v	1	0	0	1
basepi	https://github.com/basepi	0	1	0	1
bebraw	https://github.com/bebraw	1	0	0	1
becdot	https://github.com/becdot	4	1	0	5
bergie	https://github.com/bergie	1	0	0	1
bingos	https://github.com/bingos	0	1	0	1
bitrip	https://github.com/bitrip	1	1	0	2
bkueng	https://github.com/bkueng	0	1	0	1
blackc	https://github.com/blackc	1	0	0	1
blalor	https://github.com/blalor	2	1	0	3
bootsz	https://github.com/bootsz	0	2	0	2
boyska	https://github.com/boyska	0	1	0	1
br14nw	https://github.com/br14nw	1	0	0	1
breck7	https://github.com/breck7	2	2	0	4
brendo	https://github.com/brendo	0	1	0	1
brianp	https://github.com/brianp	2	0	0	2
brujo5	https://github.com/brujo5	1	0	0	1
btamas	https://github.com/btamas	1	0	0	1
btford	https://github.com/btford	1	2	0	3
btorch	https://github.com/btorch	2	0	0	2
bublik	https://github.com/bublik	6	1	0	7
bulkan	https://github.com/bulkan	0	1	0	1
bumjin	https://github.com/bumjin	1	0	0	1
bunzli	https://github.com/bunzli	1	0	0	1
bvlahh	https://github.com/bvlahh	0	1	0	1
bvogel	https://github.com/bvogel	1	0	0	1
cadorn	https://github.com/cadorn	1	0	0	1
caedes	https://github.com/caedes	1	0	0	1
cafaxo	https://github.com/cafaxo	0	4	0	4
calebx	https://github.com/calebx	1	0	0	1
cannie	https://github.com/cannie	2	1	0	3
caolan	https://github.com/caolan	0	2	0	2
careck	https://github.com/careck	0	1	0	1
careri	https://github.com/careri	2	0	0	2
carljm	https://github.com/carljm	2	0	0	2
cdtank	https://github.com/cdtank	1	0	0	1
cdujeu	https://github.com/cdujeu	0	3	0	3
cesine	https://github.com/cesine	3	1	0	4
cewing	https://github.com/cewing	1	0	0	1
cgrand	https://github.com/cgrand	0	1	0	1
chaixl	https://github.com/chaixl	1	0	0	1
chapel	https://github.com/chapel	0	1	0	1
chillu	https://github.com/chillu	1	3	0	4
chonny	https://github.com/chonny	1	0	0	1
chrcao	https://github.com/chrcao	1	0	0	1
ckundo	https://github.com/ckundo	0	3	0	3
claesb	https://github.com/claesb	0	1	0	1
cmahon	https://github.com/cmahon	0	1	0	1
cmfcmf	https://github.com/cmfcmf	1	2	0	3
cmma86	https://github.com/cmma86	4	0	0	4
cocart	https://github.com/cocart	1	1	0	2
conbud	https://github.com/conbud	1	0	0	1
coolya	https://github.com/coolya	0	2	0	2
cornae	https://github.com/cornae	1	0	0	1
cowwoc	https://github.com/cowwoc	4	0	0	4
cpence	https://github.com/cpence	3	0	0	3
cpfaff	https://github.com/cpfaff	1	0	0	1
craigh	https://github.com/craigh	1	0	0	1
creack	https://github.com/creack	1	0	0	1
croxis	https://github.com/croxis	0	2	1	3
cryo28	https://github.com/cryo28	0	1	0	1
cshold	https://github.com/cshold	1	0	0	1
cswiii	https://github.com/cswiii	17	1	0	18
cyroxx	https://github.com/cyroxx	1	0	0	1
czchen	https://github.com/czchen	1	1	0	2
dacamp	https://github.com/dacamp	0	1	0	1
dahlia	https://github.com/dahlia	0	2	0	2
daleee	https://github.com/daleee	0	1	0	1
danimo	https://github.com/danimo	0	5	0	5
darwin	https://github.com/darwin	3	0	0	3
dbin78	https://github.com/dbin78	1	0	0	1
dcloud	https://github.com/dcloud	3	2	1	6
ddbeck	https://github.com/ddbeck	0	1	0	1
deandr	https://github.com/deandr	0	1	0	1
debona	https://github.com/debona	3	0	0	3
dentex	https://github.com/dentex	0	1	0	1
dergel	https://github.com/dergel	1	0	0	1
deri82	https://github.com/deri82	1	0	0	1
dgutov	https://github.com/dgutov	0	1	0	1
dieend	https://github.com/dieend	2	0	0	2
dim00n	https://github.com/dim00n	1	0	0	1
dimkal	https://github.com/dimkal	1	1	0	2
diogob	https://github.com/diogob	0	1	0	1
disnet	https://github.com/disnet	0	4	0	4
djey47	https://github.com/djey47	1	0	0	1
dpb587	https://github.com/dpb587	0	1	0	1
dracos	https://github.com/dracos	4	3	0	7
drewww	https://github.com/drewww	1	1	0	2
drl0ve	https://github.com/drl0ve	1	0	0	1
dsegna	https://github.com/dsegna	0	1	0	1
dsrich	https://github.com/dsrich	1	0	0	1
duhlig	https://github.com/duhlig	0	1	0	1
eDiper	https://github.com/eDiper	0	1	0	1
ebidel	https://github.com/ebidel	1	2	0	3
ee7klt	https://github.com/ee7klt	5	0	0	5
egor83	https://github.com/egor83	1	0	0	1
einand	https://github.com/einand	1	0	0	1
einars	https://github.com/einars	0	1	0	1
elhoim	https://github.com/elhoim	1	1	0	2
elm232	https://github.com/elm232	0	1	0	1
emm87j	https://github.com/emm87j	1	0	0	1
epsehw	https://github.com/epsehw	1	0	0	1
erichs	https://github.com/erichs	1	0	0	1
ericmj	https://github.com/ericmj	0	4	0	4
ericpi	https://github.com/ericpi	2	0	0	2
eriohl	https://github.com/eriohl	2	0	0	2
erylee	https://github.com/erylee	1	0	0	1
espaan	https://github.com/espaan	2	1	0	3
evlist	https://github.com/evlist	0	1	0	1
excaza	https://github.com/excaza	0	1	0	1
ezcode	https://github.com/ezcode	4	0	0	4
ezzhou	https://github.com/ezzhou	1	0	0	1
fanar1	https://github.com/fanar1	1	0	0	1
fedemp	https://github.com/fedemp	1	0	0	1
feejin	https://github.com/feejin	2	0	0	2
feross	https://github.com/feross	1	0	0	1
ficoos	https://github.com/ficoos	0	1	0	1
fijimf	https://github.com/fijimf	3	5	0	8
fire64	https://github.com/fire64	1	0	0	1
firede	https://github.com/firede	1	1	0	2
fizruk	https://github.com/fizruk	4	0	0	4
flokru	https://github.com/flokru	1	1	0	2
fnagel	https://github.com/fnagel	1	0	0	1
folivi	https://github.com/folivi	1	0	0	1
fommil	https://github.com/fommil	5	2	0	7
foosel	https://github.com/foosel	0	1	0	1
fosslc	https://github.com/fosslc	4	2	0	6
foxbow	https://github.com/foxbow	1	0	0	1
franko	https://github.com/franko	1	0	0	1
freizl	https://github.com/freizl	3	0	0	3
fsouza	https://github.com/fsouza	1	0	0	1
gaaady	https://github.com/gaaady	3	1	0	4
gamtiq	https://github.com/gamtiq	1	0	0	1
gbraad	https://github.com/gbraad	0	1	0	1
gdbtek	https://github.com/gdbtek	2	1	0	3
gdietz	https://github.com/gdietz	1	1	0	2
getify	https://github.com/getify	3	4	0	7
ggreer	https://github.com/ggreer	0	1	0	1
gguava	https://github.com/gguava	1	0	0	1
ghunti	https://github.com/ghunti	0	1	0	1
gidden	https://github.com/gidden	1	0	0	1
gimick	https://github.com/gimick	1	1	0	2
gioman	https://github.com/gioman	1	0	0	1
gmario	https://github.com/gmario	1	0	0	1
gnidan	https://github.com/gnidan	0	1	0	1
gnomex	https://github.com/gnomex	1	1	0	2
gnuhub	https://github.com/gnuhub	1	0	0	1
gorlak	https://github.com/gorlak	0	1	0	1
gotdan	https://github.com/gotdan	1	0	0	1
goxofy	https://github.com/goxofy	0	1	0	1
gpaulu	https://github.com/gpaulu	1	0	0	1
gpetit	https://github.com/gpetit	1	1	0	2
grefel	https://github.com/grefel	1	0	0	1
gropax	https://github.com/gropax	0	3	0	3
gsynuh	https://github.com/gsynuh	1	0	0	1
gturri	https://github.com/gturri	0	1	0	1
gulian	https://github.com/gulian	1	0	0	1
hak8or	https://github.com/hak8or	1	5	0	6
hakuch	https://github.com/hakuch	4	0	0	4
hallas	https://github.com/hallas	1	0	0	1
hangum	https://github.com/hangum	0	3	0	3
hapali	https://github.com/hapali	1	0	0	1
harrah	https://github.com/harrah	6	0	0	6
henrik	https://github.com/henrik	1	1	0	2
henvic	https://github.com/henvic	2	0	0	2
herrri	https://github.com/herrri	1	0	0	1
hickey	https://github.com/hickey	2	1	0	3
hlamer	https://github.com/hlamer	1	1	0	2
homefc	https://github.com/homefc	1	0	0	1
hparra	https://github.com/hparra	1	0	0	1
hpxro7	https://github.com/hpxro7	1	0	0	1
hupili	https://github.com/hupili	0	2	0	2
hwride	https://github.com/hwride	1	0	0	1
i5ting	https://github.com/i5ting	1	0	0	1
i8beef	https://github.com/i8beef	4	0	0	4
iNamik	https://github.com/iNamik	1	0	0	1
ibiwan	https://github.com/ibiwan	0	1	0	1
iclems	https://github.com/iclems	1	0	0	1
igodip	https://github.com/igodip	0	19	0	19
int13h	https://github.com/int13h	1	1	0	2
irdial	https://github.com/irdial	1	0	0	1
irskep	https://github.com/irskep	4	4	0	8
iwazer	https://github.com/iwazer	1	0	0	1
j0hnds	https://github.com/j0hnds	1	0	0	1
jaBote	https://github.com/jaBote	1	0	0	1
jabley	https://github.com/jabley	0	1	0	1
jackrg	https://github.com/jackrg	1	0	0	1
jacobb	https://github.com/jacobb	0	5	0	5
jacook	https://github.com/jacook	3	0	0	3
jalava	https://github.com/jalava	1	0	0	1
jam231	https://github.com/jam231	2	4	0	6
javake	https://github.com/javake	1	0	0	1
jbenet	https://github.com/jbenet	1	0	0	1
jbphet	https://github.com/jbphet	0	2	0	2
jdutil	https://github.com/jdutil	1	0	0	1
jeredb	https://github.com/jeredb	1	1	0	2
jeremy	https://github.com/jeremy	0	1	0	1
jerith	https://github.com/jerith	1	0	0	1
jfilak	https://github.com/jfilak	1	1	0	2
jjoe64	https://github.com/jjoe64	5	4	0	9
jleyva	https://github.com/jleyva	1	0	0	1
jmwohl	https://github.com/jmwohl	0	1	0	1
jnickg	https://github.com/jnickg	1	0	0	1
joao32	https://github.com/joao32	1	2	0	3
jojo12	https://github.com/jojo12	1	2	1	4
jojoob	https://github.com/jojoob	0	2	0	2
joubin	https://github.com/joubin	2	0	0	2
jpmens	https://github.com/jpmens	1	0	0	1
jriehl	https://github.com/jriehl	0	1	0	1
jrt324	https://github.com/jrt324	1	0	0	1
jrwest	https://github.com/jrwest	8	0	0	8
jtf323	https://github.com/jtf323	3	0	0	3
jups23	https://github.com/jups23	1	0	0	1
jvatic	https://github.com/jvatic	0	1	0	1
jwaved	https://github.com/jwaved	1	0	0	1
jwormc	https://github.com/jwormc	1	0	0	1
jwtodd	https://github.com/jwtodd	1	0	0	1
k22mak	https://github.com/k22mak	1	0	0	1
k8king	https://github.com/k8king	0	1	0	1
kaduww	https://github.com/kaduww	1	0	0	1
kaelig	https://github.com/kaelig	3	0	0	3
kafene	https://github.com/kafene	0	1	0	1
kalkin	https://github.com/kalkin	1	0	0	1
kamend	https://github.com/kamend	1	0	0	1
kangax	https://github.com/kangax	0	1	0	1
kapuia	https://github.com/kapuia	1	0	0	1
karlvr	https://github.com/karlvr	0	1	0	1
kd7iwp	https://github.com/kd7iwp	1	0	0	1
kdubuc	https://github.com/kdubuc	0	1	0	1
kdungs	https://github.com/kdungs	1	0	0	1
kereid	https://github.com/kereid	1	0	0	1
kerink	https://github.com/kerink	2	0	0	2
khoran	https://github.com/khoran	2	1	0	3
kidexp	https://github.com/kidexp	0	2	0	2
kilgor	https://github.com/kilgor	1	0	0	1
kintor	https://github.com/kintor	0	1	0	1
kiorky	https://github.com/kiorky	0	1	0	1
kmsb12	https://github.com/kmsb12	1	0	0	1
kmunve	https://github.com/kmunve	5	0	0	5
koryba	https://github.com/koryba	1	0	0	1
kosl90	https://github.com/kosl90	1	1	0	2
kostja	https://github.com/kostja	1	2	0	3
kpiwko	https://github.com/kpiwko	0	1	0	1
kretes	https://github.com/kretes	1	0	0	1
krolaw	https://github.com/krolaw	0	1	0	1
kshoji	https://github.com/kshoji	0	1	0	1
ksoona	https://github.com/ksoona	0	1	0	1
ktal90	https://github.com/ktal90	1	0	0	1
kyrylo	https://github.com/kyrylo	1	1	1	3
kzahel	https://github.com/kzahel	0	0	1	1
l46kok	https://github.com/l46kok	1	0	0	1
laffen	https://github.com/laffen	0	1	0	1
lamaza	https://github.com/lamaza	1	0	0	1
lanwen	https://github.com/lanwen	1	0	0	1
lashex	https://github.com/lashex	2	0	0	2
lazedo	https://github.com/lazedo	1	0	0	1
leafdj	https://github.com/leafdj	1	0	0	1
lemire	https://github.com/lemire	0	1	0	1
leoj3n	https://github.com/leoj3n	1	0	0	1
leoner	https://github.com/leoner	1	0	0	1
leonuh	https://github.com/leonuh	1	0	0	1
leporo	https://github.com/leporo	2	0	0	2
lervag	https://github.com/lervag	0	3	0	3
lewtds	https://github.com/lewtds	2	4	0	6
lexrus	https://github.com/lexrus	1	0	0	1
lgueye	https://github.com/lgueye	1	1	0	2
liebig	https://github.com/liebig	0	2	0	2
lizzie	https://github.com/lizzie	0	1	0	1
ljodal	https://github.com/ljodal	1	0	0	1
lnxmen	https://github.com/lnxmen	2	0	0	2
loarie	https://github.com/loarie	1	0	0	1
lonico	https://github.com/lonico	1	0	0	1
lonvia	https://github.com/lonvia	0	1	0	1
loomis	https://github.com/loomis	12	1	0	13
looolz	https://github.com/looolz	1	0	0	1
lotan1	https://github.com/lotan1	1	0	0	1
lovesh	https://github.com/lovesh	1	0	0	1
lpinca	https://github.com/lpinca	0	1	0	1
lrsjng	https://github.com/lrsjng	0	1	0	1
lsegal	https://github.com/lsegal	0	1	0	1
lsemel	https://github.com/lsemel	1	1	0	2
lsmeby	https://github.com/lsmeby	1	0	0	1
lstoll	https://github.com/lstoll	1	0	0	1
lubang	https://github.com/lubang	1	0	0	1
lukhio	https://github.com/lukhio	2	0	0	2
lulebe	https://github.com/lulebe	2	0	0	2
luniki	https://github.com/luniki	4	1	0	5
luogni	https://github.com/luogni	1	0	0	1
lutorm	https://github.com/lutorm	1	0	0	1
lutter	https://github.com/lutter	2	1	0	3
mMontu	https://github.com/mMontu	2	0	0	2
macbre	https://github.com/macbre	1	0	0	1
machty	https://github.com/machty	1	1	0	2
madbob	https://github.com/madbob	1	0	0	1
magres	https://github.com/magres	0	1	0	1
main--	https://github.com/main--	0	15	0	15
manavo	https://github.com/manavo	1	0	0	1
marta-	https://github.com/marta-	1	0	0	1
maskas	https://github.com/maskas	1	1	0	2
matb33	https://github.com/matb33	1	0	0	1
matfiz	https://github.com/matfiz	1	0	0	1
mattes	https://github.com/mattes	1	5	0	6
mausch	https://github.com/mausch	18	0	0	18
maxaud	https://github.com/maxaud	1	0	0	1
maxmas	https://github.com/maxmas	3	0	0	3
mbeall	https://github.com/mbeall	1	0	0	1
mdboom	https://github.com/mdboom	0	2	0	2
mdelem	https://github.com/mdelem	1	0	0	1
meitar	https://github.com/meitar	0	1	0	1
memoht	https://github.com/memoht	1	0	0	1
mevivs	https://github.com/mevivs	3	1	0	4
mfiume	https://github.com/mfiume	0	7	0	7
mfjenn	https://github.com/mfjenn	1	0	0	1
mgcrea	https://github.com/mgcrea	0	0	1	1
mgenov	https://github.com/mgenov	1	0	0	1
mgonto	https://github.com/mgonto	0	3	0	3
mheadd	https://github.com/mheadd	2	0	0	2
mhoran	https://github.com/mhoran	0	2	0	2
mhulse	https://github.com/mhulse	3	0	0	3
miclle	https://github.com/miclle	1	0	0	1
mikeNG	https://github.com/mikeNG	1	1	0	2
mikejt	https://github.com/mikejt	0	1	0	1
mikepc	https://github.com/mikepc	1	0	0	1
mikkka	https://github.com/mikkka	0	1	0	1
mimo84	https://github.com/mimo84	0	1	0	1
mj1856	https://github.com/mj1856	4	0	1	5
mjvesa	https://github.com/mjvesa	4	1	0	5
mlaval	https://github.com/mlaval	1	0	0	1
mneorr	https://github.com/mneorr	0	1	0	1
molant	https://github.com/molant	1	0	0	1
monzou	https://github.com/monzou	1	0	0	1
moshee	https://github.com/moshee	1	0	0	1
mpapis	https://github.com/mpapis	0	1	0	1
mpilar	https://github.com/mpilar	1	0	0	1
mrclay	https://github.com/mrclay	1	0	0	1
mrdoob	https://github.com/mrdoob	0	5	0	5
mrjive	https://github.com/mrjive	1	0	0	1
mronge	https://github.com/mronge	0	1	0	1
mscdex	https://github.com/mscdex	0	1	0	1
mskala	https://github.com/mskala	1	0	0	1
msrose	https://github.com/msrose	1	1	0	2
mstang	https://github.com/mstang	1	0	0	1
mumrah	https://github.com/mumrah	0	2	0	2
mvexel	https://github.com/mvexel	1	0	0	1
mwhuss	https://github.com/mwhuss	1	0	0	1
mxgrey	https://github.com/mxgrey	1	0	0	1
mycrof	https://github.com/mycrof	33	0	0	33
mythan	https://github.com/mythan	1	0	0	1
nandub	https://github.com/nandub	1	0	0	1
narfbg	https://github.com/narfbg	0	2	0	2
natevw	https://github.com/natevw	2	1	0	3
nav712	https://github.com/nav712	1	0	0	1
nbuhay	https://github.com/nbuhay	5	2	0	7
nbxcgh	https://github.com/nbxcgh	1	0	0	1
ndland	https://github.com/ndland	1	0	0	1
neokio	https://github.com/neokio	1	0	0	1
nertzy	https://github.com/nertzy	1	0	0	1
netxph	https://github.com/netxph	3	1	0	4
nevill	https://github.com/nevill	1	0	0	1
nfitch	https://github.com/nfitch	1	0	0	1
nhenry	https://github.com/nhenry	0	1	0	1
niallo	https://github.com/niallo	1	0	0	1
nihco2	https://github.com/nihco2	1	1	0	2
nijotz	https://github.com/nijotz	1	0	0	1
nmicht	https://github.com/nmicht	8	0	0	8
nolman	https://github.com/nolman	1	0	0	1
ntadej	https://github.com/ntadej	0	1	0	1
nylira	https://github.com/nylira	0	1	0	1
nyucel	https://github.com/nyucel	5	0	0	5
obimod	https://github.com/obimod	4	0	0	4
ockham	https://github.com/ockham	0	4	0	4
ocombe	https://github.com/ocombe	0	1	0	1
oglops	https://github.com/oglops	1	0	0	1
olanod	https://github.com/olanod	1	0	0	1
omsoft	https://github.com/omsoft	1	0	0	1
ondrae	https://github.com/ondrae	3	0	0	3
oscott	https://github.com/oscott	2	0	0	2
othree	https://github.com/othree	0	2	1	3
pahmed	https://github.com/pahmed	1	0	0	1
patrys	https://github.com/patrys	0	1	0	1
payliu	https://github.com/payliu	1	0	0	1
pbispo	https://github.com/pbispo	4	0	0	4
pblain	https://github.com/pblain	1	0	0	1
pbouda	https://github.com/pbouda	1	0	0	1
pboyer	https://github.com/pboyer	1	3	0	4
peakpg	https://github.com/peakpg	1	2	0	3
pelson	https://github.com/pelson	2	0	0	2
peplin	https://github.com/peplin	2	0	0	2
petrba	https://github.com/petrba	1	1	0	2
phiamo	https://github.com/phiamo	0	10	0	10
phihag	https://github.com/phihag	0	2	0	2
phuhgh	https://github.com/phuhgh	1	0	0	1
pingax	https://github.com/pingax	0	1	0	1
plj541	https://github.com/plj541	1	0	0	1
pmos69	https://github.com/pmos69	4	0	0	4
proger	https://github.com/proger	4	0	0	4
puttin	https://github.com/puttin	1	0	0	1
pwnsdx	https://github.com/pwnsdx	1	0	0	1
pxlpnk	https://github.com/pxlpnk	0	1	0	1
qiaody	https://github.com/qiaody	5	0	0	5
qutang	https://github.com/qutang	1	0	0	1
radopi	https://github.com/radopi	0	1	0	1
rblaze	https://github.com/rblaze	0	1	0	1
rclark	https://github.com/rclark	1	2	0	3
rdimou	https://github.com/rdimou	1	0	0	1
redneo	https://github.com/redneo	0	2	0	2
reinpk	https://github.com/reinpk	1	0	0	1
rennan	https://github.com/rennan	0	1	0	1
renzon	https://github.com/renzon	4	4	0	8
rgasch	https://github.com/rgasch	1	0	0	1
rhodey	https://github.com/rhodey	1	0	0	1
riddle	https://github.com/riddle	1	1	0	2
rilwis	https://github.com/rilwis	1	1	0	2
ris321	https://github.com/ris321	1	0	0	1
robesz	https://github.com/robesz	0	1	0	1
robfig	https://github.com/robfig	0	1	0	1
robgur	https://github.com/robgur	1	0	0	1
robled	https://github.com/robled	1	0	0	1
rockst	https://github.com/rockst	2	0	0	2
rodyaj	https://github.com/rodyaj	1	0	0	1
rofl0r	https://github.com/rofl0r	1	0	0	1
romgen	https://github.com/romgen	1	0	0	1
ronnix	https://github.com/ronnix	0	1	0	1
rooton	https://github.com/rooton	1	0	0	1
rowanu	https://github.com/rowanu	1	0	0	1
rowatt	https://github.com/rowatt	0	5	0	5
rpedde	https://github.com/rpedde	4	1	0	5
rpruim	https://github.com/rpruim	1	0	0	1
rspeer	https://github.com/rspeer	0	2	0	2
rtyler	https://github.com/rtyler	0	2	0	2
rubemz	https://github.com/rubemz	1	0	0	1
rudjer	https://github.com/rudjer	1	0	0	1
rzolin	https://github.com/rzolin	1	0	0	1
s1monw	https://github.com/s1monw	3	4	0	7
sabman	https://github.com/sabman	0	1	0	1
sadris	https://github.com/sadris	1	0	0	1
salini	https://github.com/salini	2	0	0	2
samiux	https://github.com/samiux	1	0	0	1
samoht	https://github.com/samoht	0	3	0	3
sarxos	https://github.com/sarxos	0	1	0	1
sauer2	https://github.com/sauer2	1	0	0	1
sayakb	https://github.com/sayakb	0	1	0	1
says33	https://github.com/says33	0	3	0	3
sbutts	https://github.com/sbutts	1	0	0	1
scanny	https://github.com/scanny	0	2	0	2
schfan	https://github.com/schfan	0	1	1	2
scribu	https://github.com/scribu	1	1	0	2
scriby	https://github.com/scriby	0	1	0	1
sdague	https://github.com/sdague	1	0	0	1
searls	https://github.com/searls	3	1	0	4
searum	https://github.com/searum	0	15	0	15
seberg	https://github.com/seberg	0	1	0	1
seefan	https://github.com/seefan	1	0	0	1
segrey	https://github.com/segrey	1	0	0	1
seria2	https://github.com/seria2	1	0	0	1
severo	https://github.com/severo	7	5	0	12
sferik	https://github.com/sferik	1	3	0	4
shazow	https://github.com/shazow	1	0	0	1
shimpe	https://github.com/shimpe	0	1	0	1
shiniv	https://github.com/shiniv	1	1	0	2
shmibs	https://github.com/shmibs	1	0	0	1
shmidt	https://github.com/shmidt	1	0	0	1
shovon	https://github.com/shovon	1	0	0	1
shylux	https://github.com/shylux	4	0	0	4
sidnei	https://github.com/sidnei	1	0	0	1
simong	https://github.com/simong	0	1	0	1
sirtux	https://github.com/sirtux	1	0	0	1
sjinks	https://github.com/sjinks	1	0	0	1
sjsrey	https://github.com/sjsrey	1	0	0	1
sk0rms	https://github.com/sk0rms	1	0	0	1
skacky	https://github.com/skacky	1	0	0	1
skeeto	https://github.com/skeeto	1	2	0	3
skoren	https://github.com/skoren	1	0	0	1
slavap	https://github.com/slavap	0	2	0	2
sloria	https://github.com/sloria	1	2	0	3
smonff	https://github.com/smonff	1	0	0	1
smurfy	https://github.com/smurfy	2	2	0	4
snikch	https://github.com/snikch	1	0	0	1
soffes	https://github.com/soffes	0	1	0	1
sorenu	https://github.com/sorenu	1	0	0	1
sorgoz	https://github.com/sorgoz	1	1	0	2
spaggi	https://github.com/spaggi	2	1	0	3
spicyj	https://github.com/spicyj	0	1	0	1
squeen	https://github.com/squeen	1	0	0	1
st3fan	https://github.com/st3fan	1	3	0	4
stackp	https://github.com/stackp	0	1	0	1
stevan	https://github.com/stevan	0	1	0	1
stiggg	https://github.com/stiggg	2	0	0	2
struan	https://github.com/struan	1	1	0	2
stuaxo	https://github.com/stuaxo	5	0	0	5
stunti	https://github.com/stunti	0	1	0	1
sukima	https://github.com/sukima	1	0	0	1
sustr4	https://github.com/sustr4	0	1	0	1
svnlto	https://github.com/svnlto	0	2	0	2
swidup	https://github.com/swidup	17	0	1	18
syagev	https://github.com/syagev	1	0	0	1
synlag	https://github.com/synlag	1	0	0	1
szwacz	https://github.com/szwacz	1	0	0	1
t999uk	https://github.com/t999uk	1	0	0	1
tafypz	https://github.com/tafypz	0	1	0	1
talexb	https://github.com/talexb	0	1	0	1
tangmi	https://github.com/tangmi	2	0	0	2
taragb	https://github.com/taragb	3	0	0	3
targon	https://github.com/targon	1	0	0	1
tboloo	https://github.com/tboloo	1	0	0	1
tboyko	https://github.com/tboyko	1	1	0	2
teamon	https://github.com/teamon	1	0	0	1
tfitts	https://github.com/tfitts	1	0	0	1
tfoote	https://github.com/tfoote	3	5	0	8
thedax	https://github.com/thedax	1	0	0	1
theory	https://github.com/theory	1	0	0	1
thisch	https://github.com/thisch	1	0	0	1
thmzlt	https://github.com/thmzlt	1	0	0	1
thoppe	https://github.com/thoppe	1	0	0	1
throgh	https://github.com/throgh	0	1	0	1
tidyui	https://github.com/tidyui	1	0	0	1
tigerw	https://github.com/tigerw	1	0	0	1
timmie	https://github.com/timmie	0	1	0	1
timtan	https://github.com/timtan	1	0	0	1
timwis	https://github.com/timwis	0	1	0	1
tinogo	https://github.com/tinogo	1	0	0	1
tkirda	https://github.com/tkirda	0	1	0	1
tmatth	https://github.com/tmatth	1	0	0	1
tobias	https://github.com/tobias	1	0	0	1
tobium	https://github.com/tobium	1	0	0	1
tokudu	https://github.com/tokudu	0	2	0	2
tomesj	https://github.com/tomesj	0	2	0	2
tontof	https://github.com/tontof	0	2	0	2
tookko	https://github.com/tookko	1	0	0	1
tremby	https://github.com/tremby	1	0	0	1
trentm	https://github.com/trentm	1	0	0	1
troyth	https://github.com/troyth	0	2	0	2
tsfana	https://github.com/tsfana	1	0	0	1
tuxone	https://github.com/tuxone	1	0	0	1
twokul	https://github.com/twokul	1	0	0	1
tyssen	https://github.com/tyssen	1	0	0	1
tzador	https://github.com/tzador	4	0	0	4
ugorji	https://github.com/ugorji	0	1	1	2
ukinau	https://github.com/ukinau	0	1	0	1
ulgens	https://github.com/ulgens	1	0	0	1
unerds	https://github.com/unerds	0	2	0	2
usharf	https://github.com/usharf	1	0	0	1
vagari	https://github.com/vagari	1	0	0	1
vaidik	https://github.com/vaidik	0	1	0	1
vdboor	https://github.com/vdboor	1	0	0	1
veadar	https://github.com/veadar	1	0	0	1
vedang	https://github.com/vedang	3	0	0	3
veegee	https://github.com/veegee	0	1	0	1
vfonic	https://github.com/vfonic	1	0	0	1
vikkun	https://github.com/vikkun	1	0	0	1
visik7	https://github.com/visik7	1	0	0	1
voidus	https://github.com/voidus	1	0	0	1
voltan	https://github.com/voltan	0	1	0	1
vralfy	https://github.com/vralfy	1	0	0	1
vuvlab	https://github.com/vuvlab	1	0	0	1
w8tcha	https://github.com/w8tcha	1	2	0	3
waldoj	https://github.com/waldoj	3	0	1	4
walter	https://github.com/walter	3	3	0	6
watwel	https://github.com/watwel	1	0	0	1
weweje	https://github.com/weweje	1	0	0	1
wezell	https://github.com/wezell	1	0	0	1
whadar	https://github.com/whadar	1	3	0	4
wienke	https://github.com/wienke	1	0	0	1
willcc	https://github.com/willcc	1	0	0	1
wilpig	https://github.com/wilpig	0	3	0	3
wino45	https://github.com/wino45	1	0	0	1
winocm	https://github.com/winocm	0	1	0	1
wizzat	https://github.com/wizzat	1	1	0	2
wkeese	https://github.com/wkeese	1	0	0	1
wokier	https://github.com/wokier	1	0	0	1
wpreul	https://github.com/wpreul	0	1	0	1
wtaeke	https://github.com/wtaeke	1	0	0	1
wuurrd	https://github.com/wuurrd	1	0	0	1
wycats	https://github.com/wycats	0	13	0	13
x3ro89	https://github.com/x3ro89	1	0	0	1
xaratt	https://github.com/xaratt	1	0	0	1
xblitz	https://github.com/xblitz	1	0	0	1
xenyou	https://github.com/xenyou	0	1	0	1
xeross	https://github.com/xeross	1	0	0	1
xiaods	https://github.com/xiaods	0	1	0	1
xikenx	https://github.com/xikenx	1	0	0	1
xivaxy	https://github.com/xivaxy	1	0	0	1
xnramx	https://github.com/xnramx	1	0	0	1
xxxajk	https://github.com/xxxajk	1	0	0	1
yak1ex	https://github.com/yak1ex	4	5	0	9
yallop	https://github.com/yallop	0	1	0	1
yandod	https://github.com/yandod	2	0	0	2
ydaniv	https://github.com/ydaniv	1	1	0	2
yfyang	https://github.com/yfyang	0	1	0	1
yizeng	https://github.com/yizeng	1	1	0	2
ynunez	https://github.com/ynunez	1	1	0	2
yo-han	https://github.com/yo-han	0	1	1	2
yomguy	https://github.com/yomguy	0	0	1	1
yoonj4	https://github.com/yoonj4	0	1	0	1
yordaa	https://github.com/yordaa	1	0	0	1
youkei	https://github.com/youkei	1	0	0	1
yuklai	https://github.com/yuklai	1	0	0	1
zahhak	https://github.com/zahhak	1	0	0	1
zarboz	https://github.com/zarboz	1	0	0	1
zarino	https://github.com/zarino	2	1	0	3
zender	https://github.com/zender	0	2	0	2
zeress	https://github.com/zeress	1	1	0	2
zhando	https://github.com/zhando	1	0	0	1
zigmal	https://github.com/zigmal	0	1	0	1
zk-phi	https://github.com/zk-phi	0	1	0	1
zongai	https://github.com/zongai	1	0	0	1
zunuk1	https://github.com/zunuk1	2	0	0	2
zxiiro	https://github.com/zxiiro	1	0	0	1
1800joe	https://github.com/1800joe	1	0	0	1
1eddy87	https://github.com/1eddy87	1	0	0	1
28Black	https://github.com/28Black	1	0	0	1
39dotyt	https://github.com/39dotyt	1	0	0	1
7nights	https://github.com/7nights	1	0	0	1
ALeMire	https://github.com/ALeMire	0	1	0	1
Abhoryo	https://github.com/Abhoryo	0	1	0	1
Aklakan	https://github.com/Aklakan	3	0	0	3
Alerion	https://github.com/Alerion	0	1	0	1
Alex-Sh	https://github.com/Alex-Sh	1	0	0	1
Andr3as	https://github.com/Andr3as	0	1	0	1
Anelith	https://github.com/Anelith	0	2	0	2
Arkezis	https://github.com/Arkezis	1	0	0	1
ArtForz	https://github.com/ArtForz	0	1	0	1
Astraxa	https://github.com/Astraxa	1	0	0	1
Azurago	https://github.com/Azurago	1	1	0	2
BFTrick	https://github.com/BFTrick	1	0	0	1
BR0kEN-	https://github.com/BR0kEN-	1	2	0	3
Bean427	https://github.com/Bean427	1	0	0	1
Bimalvv	https://github.com/Bimalvv	1	0	0	1
Bjorn32	https://github.com/Bjorn32	3	0	0	3
Blaqwar	https://github.com/Blaqwar	2	0	0	2
Bloodie	https://github.com/Bloodie	1	0	0	1
BluB0lt	https://github.com/BluB0lt	1	0	0	1
Bodyash	https://github.com/Bodyash	1	0	0	1
Bortseb	https://github.com/Bortseb	2	0	0	2
Calyhre	https://github.com/Calyhre	0	1	0	1
Caspern	https://github.com/Caspern	1	0	0	1
Chiel92	https://github.com/Chiel92	1	0	0	1
ChrisK2	https://github.com/ChrisK2	1	0	0	1
ChuckHa	https://github.com/ChuckHa	3	1	0	4
Churten	https://github.com/Churten	1	0	0	1
Cokegod	https://github.com/Cokegod	1	1	0	2
Craga89	https://github.com/Craga89	0	1	0	1
DBheart	https://github.com/DBheart	2	0	0	2
Darutik	https://github.com/Darutik	2	1	0	3
DasBlub	https://github.com/DasBlub	1	0	0	1
DeeJaVu	https://github.com/DeeJaVu	1	0	0	1
Douwe92	https://github.com/Douwe92	1	0	0	1
Dynalon	https://github.com/Dynalon	0	1	0	1
EdLeafe	https://github.com/EdLeafe	1	0	0	1
Elbandi	https://github.com/Elbandi	1	0	0	1
Ely51um	https://github.com/Ely51um	0	6	0	6
Ennazus	https://github.com/Ennazus	2	3	0	5
ErshKUS	https://github.com/ErshKUS	0	1	0	1
FRosner	https://github.com/FRosner	3	3	0	6
Ferin15	https://github.com/Ferin15	1	0	0	1
FroMage	https://github.com/FroMage	2	1	1	4
Fsu0413	https://github.com/Fsu0413	0	1	0	1
GalinaV	https://github.com/GalinaV	1	0	0	1
Gatleos	https://github.com/Gatleos	1	0	0	1
GitNiko	https://github.com/GitNiko	3	3	0	6
Glandos	https://github.com/Glandos	0	1	0	1
Gloooom	https://github.com/Gloooom	1	1	0	2
GrantSP	https://github.com/GrantSP	1	0	0	1
Greduan	https://github.com/Greduan	0	1	0	1
H15teve	https://github.com/H15teve	0	1	0	1
HRanDEV	https://github.com/HRanDEV	1	0	0	1
Haacked	https://github.com/Haacked	1	15	0	16
Hexcles	https://github.com/Hexcles	1	1	0	2
Homfrog	https://github.com/Homfrog	1	0	0	1
JChrist	https://github.com/JChrist	0	1	0	1
Jeebiss	https://github.com/Jeebiss	1	0	0	1
Jenovas	https://github.com/Jenovas	0	1	0	1
Jimtrim	https://github.com/Jimtrim	1	0	0	1
JohnDoh	https://github.com/JohnDoh	0	1	0	1
JonRowe	https://github.com/JonRowe	0	1	0	1
K-ballo	https://github.com/K-ballo	0	1	0	1
Kimundi	https://github.com/Kimundi	1	1	0	2
Koronen	https://github.com/Koronen	1	0	0	1
LazZer-	https://github.com/LazZer-	0	3	0	3
Lynngre	https://github.com/Lynngre	12	1	0	13
MaPePeR	https://github.com/MaPePeR	1	0	0	1
MadcowD	https://github.com/MadcowD	0	0	1	1
Marlinc	https://github.com/Marlinc	1	0	0	1
McSkops	https://github.com/McSkops	1	0	0	1
Micka33	https://github.com/Micka33	1	0	0	1
MikeR13	https://github.com/MikeR13	13	6	0	19
Morriar	https://github.com/Morriar	30	21	0	51
Mr0grog	https://github.com/Mr0grog	1	0	0	1
MyXoToD	https://github.com/MyXoToD	0	1	0	1
Narretz	https://github.com/Narretz	1	0	0	1
Neputin	https://github.com/Neputin	1	0	0	1
Niggler	https://github.com/Niggler	1	0	0	1
Niichan	https://github.com/Niichan	0	1	0	1
Nuc1eoN	https://github.com/Nuc1eoN	0	1	0	1
OleJack	https://github.com/OleJack	1	0	0	1
OniBait	https://github.com/OniBait	0	1	0	1
Pagghiu	https://github.com/Pagghiu	1	0	0	1
PeeJeff	https://github.com/PeeJeff	1	0	0	1
Piedone	https://github.com/Piedone	1	0	0	1
Plonk42	https://github.com/Plonk42	0	1	0	1
PragTob	https://github.com/PragTob	2	1	0	3
Pychimp	https://github.com/Pychimp	1	0	0	1
Rafaila	https://github.com/Rafaila	1	0	0	1
RayKwon	https://github.com/RayKwon	1	0	0	1
Raytray	https://github.com/Raytray	1	0	0	1
Rebolon	https://github.com/Rebolon	1	0	0	1
Rusherz	https://github.com/Rusherz	1	0	0	1
S0lll0s	https://github.com/S0lll0s	1	0	0	1
SCIIEMH	https://github.com/SCIIEMH	6	0	0	6
Sarcasm	https://github.com/Sarcasm	1	0	0	1
Sedushi	https://github.com/Sedushi	1	1	0	2
Seldaek	https://github.com/Seldaek	2	2	0	4
Shauren	https://github.com/Shauren	0	1	0	1
Shukaro	https://github.com/Shukaro	0	2	0	2
SidhNor	https://github.com/SidhNor	1	0	0	1
SimonVT	https://github.com/SimonVT	0	2	0	2
Slayvin	https://github.com/Slayvin	1	0	0	1
Sortivo	https://github.com/Sortivo	0	1	0	1
Sparksx	https://github.com/Sparksx	1	0	0	1
Spica99	https://github.com/Spica99	1	0	0	1
Spitler	https://github.com/Spitler	0	5	0	5
Strayer	https://github.com/Strayer	1	0	0	1
Svyatov	https://github.com/Svyatov	2	0	0	2
TalAter	https://github.com/TalAter	0	1	0	1
Tales23	https://github.com/Tales23	1	0	0	1
Tharine	https://github.com/Tharine	1	0	0	1
TiuTalk	https://github.com/TiuTalk	2	0	0	2
TommyB3	https://github.com/TommyB3	1	0	0	1
Trucido	https://github.com/Trucido	1	0	0	1
Turbo87	https://github.com/Turbo87	2	1	0	3
UnnDunn	https://github.com/UnnDunn	1	1	0	2
Vaygrim	https://github.com/Vaygrim	3	0	0	3
Visgean	https://github.com/Visgean	2	0	0	2
VladasX	https://github.com/VladasX	1	0	0	1
WebbyIT	https://github.com/WebbyIT	1	0	0	1
Wiinter	https://github.com/Wiinter	1	0	0	1
XxACMxX	https://github.com/XxACMxX	1	0	0	1
a456003	https://github.com/a456003	1	0	0	1
aauthor	https://github.com/aauthor	1	0	0	1
abadams	https://github.com/abadams	0	1	0	1
abenzer	https://github.com/abenzer	0	3	0	3
abinoda	https://github.com/abinoda	1	0	0	1
abmargb	https://github.com/abmargb	0	1	0	1
aburkut	https://github.com/aburkut	0	1	0	1
adamaoc	https://github.com/adamaoc	9	1	0	10
adaussy	https://github.com/adaussy	2	1	0	3
adhishm	https://github.com/adhishm	0	1	0	1
aditya-	https://github.com/aditya-	0	1	0	1
afcowie	https://github.com/afcowie	0	1	1	2
afinzel	https://github.com/afinzel	1	0	0	1
agektmr	https://github.com/agektmr	1	0	0	1
agirbal	https://github.com/agirbal	1	0	0	1
aheinze	https://github.com/aheinze	0	3	0	3
aizzo73	https://github.com/aizzo73	1	0	0	1
akegalj	https://github.com/akegalj	1	0	0	1
akiiiii	https://github.com/akiiiii	1	0	0	1
akshay-	https://github.com/akshay-	1	0	0	1
akshayp	https://github.com/akshayp	1	0	0	1
alanbbr	https://github.com/alanbbr	1	0	0	1
alawibh	https://github.com/alawibh	1	0	0	1
aleks-f	https://github.com/aleks-f	0	1	0	1
alemau5	https://github.com/alemau5	1	0	0	1
alexreg	https://github.com/alexreg	1	0	0	1
alexw23	https://github.com/alexw23	1	1	0	2
alexyan	https://github.com/alexyan	1	0	0	1
allanmc	https://github.com/allanmc	0	1	0	1
alvisir	https://github.com/alvisir	0	1	0	1
amayers	https://github.com/amayers	1	0	0	1
amdlabs	https://github.com/amdlabs	1	0	0	1
amrutav	https://github.com/amrutav	1	0	0	1
anarute	https://github.com/anarute	0	2	0	2
andrely	https://github.com/andrely	1	0	0	1
andrepl	https://github.com/andrepl	0	1	0	1
andris9	https://github.com/andris9	0	1	0	1
andylou	https://github.com/andylou	2	0	0	2
angeloh	https://github.com/angeloh	1	1	0	2
anisbet	https://github.com/anisbet	1	1	0	2
apipkin	https://github.com/apipkin	0	1	0	1
apnerve	https://github.com/apnerve	1	0	0	1
apoleon	https://github.com/apoleon	2	0	0	2
araydin	https://github.com/araydin	1	0	0	1
arbolis	https://github.com/arbolis	1	0	0	1
arcan1s	https://github.com/arcan1s	1	0	0	1
arecarn	https://github.com/arecarn	1	2	0	3
argerim	https://github.com/argerim	0	3	0	3
aried3r	https://github.com/aried3r	1	0	0	1
arjungm	https://github.com/arjungm	1	0	0	1
arpetti	https://github.com/arpetti	2	1	0	3
arr2036	https://github.com/arr2036	0	1	0	1
artem-v	https://github.com/artem-v	3	0	0	3
arturoc	https://github.com/arturoc	0	1	0	1
asbjorn	https://github.com/asbjorn	1	0	0	1
asdcdow	https://github.com/asdcdow	1	0	0	1
asdil12	https://github.com/asdil12	1	0	0	1
ashwinr	https://github.com/ashwinr	1	0	0	1
asilano	https://github.com/asilano	1	0	0	1
aspyker	https://github.com/aspyker	0	1	0	1
astaxie	https://github.com/astaxie	0	1	0	1
astrada	https://github.com/astrada	0	1	0	1
audreyt	https://github.com/audreyt	0	2	0	2
austinz	https://github.com/austinz	1	0	0	1
avelino	https://github.com/avelino	2	0	0	2
avihric	https://github.com/avihric	0	1	0	1
avinsol	https://github.com/avinsol	2	0	0	2
ayedee2	https://github.com/ayedee2	1	0	0	1
ayublin	https://github.com/ayublin	1	2	1	4
azawawi	https://github.com/azawawi	1	0	0	1
b4silio	https://github.com/b4silio	1	0	0	1
babb517	https://github.com/babb517	1	0	0	1
bagnell	https://github.com/bagnell	0	1	0	1
baisong	https://github.com/baisong	2	0	0	2
bakercp	https://github.com/bakercp	5	1	0	6
balhoff	https://github.com/balhoff	1	0	0	1
banncan	https://github.com/banncan	1	0	0	1
barbeau	https://github.com/barbeau	2	5	0	7
bartvde	https://github.com/bartvde	1	0	0	1
bashaus	https://github.com/bashaus	0	1	0	1
bastimm	https://github.com/bastimm	1	0	0	1
bendlas	https://github.com/bendlas	1	0	0	1
benehsv	https://github.com/benehsv	1	0	0	1
benjamn	https://github.com/benjamn	0	1	0	1
bennofs	https://github.com/bennofs	1	0	0	1
benouat	https://github.com/benouat	0	1	0	1
benstof	https://github.com/benstof	6	2	0	8
bgarate	https://github.com/bgarate	1	0	0	1
bhvijay	https://github.com/bhvijay	1	0	0	1
bigeyex	https://github.com/bigeyex	5	0	0	5
billiob	https://github.com/billiob	0	1	0	1
bingzer	https://github.com/bingzer	1	0	0	1
bircoph	https://github.com/bircoph	1	0	0	1
bissaum	https://github.com/bissaum	1	0	0	1
bizmate	https://github.com/bizmate	0	1	0	1
blacked	https://github.com/blacked	1	0	0	1
blowsie	https://github.com/blowsie	1	1	0	2
blueimp	https://github.com/blueimp	0	3	0	3
bluemel	https://github.com/bluemel	1	0	0	1
bnickel	https://github.com/bnickel	0	6	0	6
bobkare	https://github.com/bobkare	1	0	0	1
bogdanm	https://github.com/bogdanm	0	1	0	1
bolandb	https://github.com/bolandb	1	0	0	1
boredzo	https://github.com/boredzo	0	1	0	1
boutell	https://github.com/boutell	0	1	0	1
boy-jer	https://github.com/boy-jer	1	0	0	1
bradkav	https://github.com/bradkav	1	0	0	1
brycesw	https://github.com/brycesw	2	0	0	2
bsideup	https://github.com/bsideup	1	0	0	1
bsjones	https://github.com/bsjones	1	0	0	1
bswopes	https://github.com/bswopes	1	0	0	1
btknorr	https://github.com/btknorr	1	0	0	1
btmdave	https://github.com/btmdave	1	1	1	3
butch2k	https://github.com/butch2k	0	1	0	1
bzamora	https://github.com/bzamora	1	0	0	1
cad-san	https://github.com/cad-san	1	0	0	1
cadavre	https://github.com/cadavre	1	0	0	1
cage433	https://github.com/cage433	0	6	0	6
callmez	https://github.com/callmez	1	0	0	1
camilou	https://github.com/camilou	1	1	0	2
canfiax	https://github.com/canfiax	2	0	0	2
capooti	https://github.com/capooti	3	1	0	4
cathyjf	https://github.com/cathyjf	1	0	0	1
catwell	https://github.com/catwell	1	0	0	1
caulagi	https://github.com/caulagi	7	4	0	11
cayasso	https://github.com/cayasso	1	0	0	1
cbigler	https://github.com/cbigler	1	0	0	1
cchow32	https://github.com/cchow32	2	0	1	3
ccverak	https://github.com/ccverak	1	0	0	1
cefoley	https://github.com/cefoley	5	1	0	6
cgjones	https://github.com/cgjones	2	2	0	4
chafe66	https://github.com/chafe66	1	0	0	1
chakrit	https://github.com/chakrit	1	0	0	1
chantra	https://github.com/chantra	0	0	1	1
charris	https://github.com/charris	1	1	0	2
cheddar	https://github.com/cheddar	1	0	0	1
cherest	https://github.com/cherest	4	0	0	4
chewyf5	https://github.com/chewyf5	1	0	0	1
chochos	https://github.com/chochos	1	1	0	2
cholmes	https://github.com/cholmes	5	0	0	5
chonthu	https://github.com/chonthu	0	1	0	1
chooper	https://github.com/chooper	0	1	0	1
chrisdo	https://github.com/chrisdo	1	0	0	1
chryton	https://github.com/chryton	1	0	0	1
chz1030	https://github.com/chz1030	1	0	0	1
ciberch	https://github.com/ciberch	1	1	0	2
cjmagee	https://github.com/cjmagee	1	0	0	1
ckeboss	https://github.com/ckeboss	1	1	0	2
clehner	https://github.com/clehner	1	0	0	1
clioweb	https://github.com/clioweb	0	1	0	1
cmaglie	https://github.com/cmaglie	0	1	0	1
cmchase	https://github.com/cmchase	3	1	0	4
cmegown	https://github.com/cmegown	1	0	0	1
colinta	https://github.com/colinta	0	1	0	1
cpaasch	https://github.com/cpaasch	0	1	0	1
crowbot	https://github.com/crowbot	2	1	0	3
cscheid	https://github.com/cscheid	2	0	0	2
csexton	https://github.com/csexton	0	1	0	1
ctasada	https://github.com/ctasada	0	2	0	2
cuter44	https://github.com/cuter44	1	0	0	1
cybaman	https://github.com/cybaman	1	2	1	4
czardoz	https://github.com/czardoz	3	0	0	3
daddeo2	https://github.com/daddeo2	0	1	0	1
dakrone	https://github.com/dakrone	0	1	0	1
damiann	https://github.com/damiann	1	1	0	2
dangoor	https://github.com/dangoor	1	1	0	2
danlbek	https://github.com/danlbek	2	2	0	4
dannydb	https://github.com/dannydb	0	2	0	2
dansdsu	https://github.com/dansdsu	4	0	2	6
dansolo	https://github.com/dansolo	1	0	0	1
darashi	https://github.com/darashi	10	0	0	10
darobin	https://github.com/darobin	0	1	0	1
daveliu	https://github.com/daveliu	1	0	0	1
davesag	https://github.com/davesag	1	0	0	1
davidjb	https://github.com/davidjb	1	0	0	1
davidll	https://github.com/davidll	0	2	0	2
dburles	https://github.com/dburles	1	0	0	1
dbutaye	https://github.com/dbutaye	1	0	0	1
dcernst	https://github.com/dcernst	1	0	0	1
dcgauld	https://github.com/dcgauld	0	3	0	3
dcodeIO	https://github.com/dcodeIO	0	2	0	2
dcposch	https://github.com/dcposch	5	1	0	6
ddawson	https://github.com/ddawson	0	1	0	1
delfrrr	https://github.com/delfrrr	1	0	0	1
demitri	https://github.com/demitri	1	0	0	1
demlaip	https://github.com/demlaip	1	1	0	2
der-flo	https://github.com/der-flo	0	1	0	1
derenix	https://github.com/derenix	1	0	0	1
deshipu	https://github.com/deshipu	1	0	0	1
despens	https://github.com/despens	1	0	0	1
dev4dev	https://github.com/dev4dev	0	1	0	1
devxdev	https://github.com/devxdev	1	0	0	1
dgraham	https://github.com/dgraham	0	1	0	1
dideler	https://github.com/dideler	1	2	0	3
diogo10	https://github.com/diogo10	1	0	0	1
dkauf42	https://github.com/dkauf42	1	0	0	1
dlnufox	https://github.com/dlnufox	1	0	0	1
dmilith	https://github.com/dmilith	0	1	0	1
dnephin	https://github.com/dnephin	1	0	0	1
docvego	https://github.com/docvego	1	1	0	2
dogtato	https://github.com/dogtato	1	0	0	1
domenic	https://github.com/domenic	0	2	0	2
domnikl	https://github.com/domnikl	2	0	0	2
donseba	https://github.com/donseba	1	0	0	1
dpetzel	https://github.com/dpetzel	2	0	0	2
dpocock	https://github.com/dpocock	0	1	0	1
dpripas	https://github.com/dpripas	1	0	0	1
drbrain	https://github.com/drbrain	0	1	0	1
dream89	https://github.com/dream89	2	1	0	3
dremoor	https://github.com/dremoor	1	0	0	1
dretrex	https://github.com/dretrex	1	0	0	1
drkitty	https://github.com/drkitty	1	0	0	1
drublic	https://github.com/drublic	0	2	0	2
drussel	https://github.com/drussel	1	0	0	1
dsheets	https://github.com/dsheets	1	1	0	2
dualbus	https://github.com/dualbus	2	1	0	3
dunglas	https://github.com/dunglas	1	1	0	2
dwblair	https://github.com/dwblair	1	0	0	1
dziudek	https://github.com/dziudek	0	1	0	1
ebolker	https://github.com/ebolker	1	0	0	1
efullea	https://github.com/efullea	0	1	0	1
ehedaya	https://github.com/ehedaya	0	1	0	1
ehouais	https://github.com/ehouais	1	0	0	1
elazarl	https://github.com/elazarl	0	0	1	1
elehcim	https://github.com/elehcim	4	0	0	4
elfring	https://github.com/elfring	1	0	0	1
elizuck	https://github.com/elizuck	3	3	0	6
eolwral	https://github.com/eolwral	1	0	0	1
erajabi	https://github.com/erajabi	1	0	0	1
ericras	https://github.com/ericras	1	1	0	2
eripong	https://github.com/eripong	1	0	0	1
esculli	https://github.com/esculli	0	1	0	1
etdsoft	https://github.com/etdsoft	4	1	0	5
etrepum	https://github.com/etrepum	1	0	0	1
evalica	https://github.com/evalica	1	1	0	2
evan3rd	https://github.com/evan3rd	5	3	0	8
evanphx	https://github.com/evanphx	0	10	0	10
ewallah	https://github.com/ewallah	2	0	0	2
exarkun	https://github.com/exarkun	1	0	0	1
eythian	https://github.com/eythian	2	0	0	2
ezephyr	https://github.com/ezephyr	1	0	0	1
faishal	https://github.com/faishal	0	1	0	1
far4599	https://github.com/far4599	1	0	0	1
fbender	https://github.com/fbender	1	0	0	1
fedorov	https://github.com/fedorov	0	1	0	1
fhntv24	https://github.com/fhntv24	1	0	0	1
fillest	https://github.com/fillest	6	0	0	6
fkooman	https://github.com/fkooman	4	0	0	4
flesser	https://github.com/flesser	1	0	0	1
flogith	https://github.com/flogith	1	0	0	1
fmilepe	https://github.com/fmilepe	0	1	0	1
fnichol	https://github.com/fnichol	1	0	0	1
fobazzz	https://github.com/fobazzz	1	0	0	1
fooobar	https://github.com/fooobar	1	1	0	2
fotomut	https://github.com/fotomut	1	0	0	1
fperrad	https://github.com/fperrad	0	1	0	1
frabass	https://github.com/frabass	2	0	0	2
frabbit	https://github.com/frabbit	1	0	0	1
fran6co	https://github.com/fran6co	0	1	0	1
frapeti	https://github.com/frapeti	0	1	0	1
frejbow	https://github.com/frejbow	4	0	0	4
frsyuki	https://github.com/frsyuki	0	1	0	1
fserena	https://github.com/fserena	1	0	0	1
funivan	https://github.com/funivan	1	4	0	5
fwitzke	https://github.com/fwitzke	1	0	0	1
gabmecu	https://github.com/gabmecu	6	1	0	7
galip91	https://github.com/galip91	1	0	0	1
gboslee	https://github.com/gboslee	1	0	0	1
genadyp	https://github.com/genadyp	0	1	0	1
genis59	https://github.com/genis59	2	2	0	4
gensior	https://github.com/gensior	1	0	0	1
getdave	https://github.com/getdave	6	7	0	13
gfreeau	https://github.com/gfreeau	0	1	0	1
gilden-	https://github.com/gilden-	1	0	0	1
gillesB	https://github.com/gillesB	1	6	0	7
girving	https://github.com/girving	9	2	0	11
gkatsev	https://github.com/gkatsev	1	0	0	1
glykose	https://github.com/glykose	1	0	0	1
gmblack	https://github.com/gmblack	1	0	0	1
gonzomw	https://github.com/gonzomw	1	0	0	1
gothicx	https://github.com/gothicx	1	0	0	1
goyox86	https://github.com/goyox86	1	0	0	1
gquadro	https://github.com/gquadro	0	1	0	1
grahamb	https://github.com/grahamb	1	0	0	1
grechaw	https://github.com/grechaw	0	2	0	2
greyshi	https://github.com/greyshi	1	0	0	1
gruehle	https://github.com/gruehle	0	1	0	1
gsoltis	https://github.com/gsoltis	1	0	0	1
guersam	https://github.com/guersam	1	0	0	1
guettli	https://github.com/guettli	1	0	0	1
guzjang	https://github.com/guzjang	1	0	0	1
h2lsoft	https://github.com/h2lsoft	11	0	0	11
hackedd	https://github.com/hackedd	2	0	0	2
hakimel	https://github.com/hakimel	0	2	0	2
hallard	https://github.com/hallard	1	0	0	1
hampelm	https://github.com/hampelm	3	0	0	3
hannesd	https://github.com/hannesd	0	1	0	1
hayesgm	https://github.com/hayesgm	1	0	0	1
hcpeter	https://github.com/hcpeter	1	0	0	1
hdaniel	https://github.com/hdaniel	1	1	0	2
hellais	https://github.com/hellais	2	0	0	2
hhoover	https://github.com/hhoover	1	0	0	1
hkaiser	https://github.com/hkaiser	0	1	0	1
hnrgrgr	https://github.com/hnrgrgr	1	0	0	1
hoelzro	https://github.com/hoelzro	1	0	0	1
hottubb	https://github.com/hottubb	2	2	0	4
hulufei	https://github.com/hulufei	1	0	0	1
humitos	https://github.com/humitos	2	1	0	3
ialbert	https://github.com/ialbert	0	1	0	1
iamtyce	https://github.com/iamtyce	0	1	0	1
icelava	https://github.com/icelava	0	1	0	1
idanhen	https://github.com/idanhen	1	0	0	1
idroxid	https://github.com/idroxid	0	1	0	1
imbrito	https://github.com/imbrito	15	0	0	15
immerrr	https://github.com/immerrr	0	1	0	1
impaler	https://github.com/impaler	1	0	0	1
imrahil	https://github.com/imrahil	1	0	0	1
indutny	https://github.com/indutny	0	4	1	5
irwinai	https://github.com/irwinai	1	0	0	1
isaacrg	https://github.com/isaacrg	1	0	0	1
ishahid	https://github.com/ishahid	1	1	0	2
itdoors	https://github.com/itdoors	0	1	1	2
jaderhs	https://github.com/jaderhs	1	0	0	1
jaekwon	https://github.com/jaekwon	1	0	0	1
jaimeMF	https://github.com/jaimeMF	0	3	0	3
jakob-e	https://github.com/jakob-e	1	0	0	1
jakub-g	https://github.com/jakub-g	1	0	0	1
janeyee	https://github.com/janeyee	1	0	0	1
japdlsd	https://github.com/japdlsd	1	0	0	1
jaredly	https://github.com/jaredly	1	1	0	2
jastram	https://github.com/jastram	2	16	0	18
javakat	https://github.com/javakat	2	7	0	9
jayarjo	https://github.com/jayarjo	0	5	0	5
jayzeng	https://github.com/jayzeng	4	0	0	4
jbeales	https://github.com/jbeales	0	1	0	1
jboulen	https://github.com/jboulen	2	0	0	2
jbrogan	https://github.com/jbrogan	1	0	0	1
jcoglan	https://github.com/jcoglan	0	1	0	1
jdalsem	https://github.com/jdalsem	1	0	0	1
jdcasey	https://github.com/jdcasey	1	0	0	1
jdiez17	https://github.com/jdiez17	3	0	0	3
jdonson	https://github.com/jdonson	3	0	0	3
jeluard	https://github.com/jeluard	1	0	0	1
jemadux	https://github.com/jemadux	1	0	0	1
jennybc	https://github.com/jennybc	1	0	0	1
jensalm	https://github.com/jensalm	0	1	0	1
jensens	https://github.com/jensens	1	0	0	1
jepetko	https://github.com/jepetko	3	0	0	3
jeremyf	https://github.com/jeremyf	3	1	0	4
jeroenj	https://github.com/jeroenj	1	0	0	1
jessedc	https://github.com/jessedc	0	1	0	1
jgeurts	https://github.com/jgeurts	0	3	0	3
jgillis	https://github.com/jgillis	1	1	0	2
jhigman	https://github.com/jhigman	1	0	0	1
jinkuen	https://github.com/jinkuen	5	2	0	7
jjmasse	https://github.com/jjmasse	2	1	0	3
jkaberg	https://github.com/jkaberg	1	0	0	1
jmalloc	https://github.com/jmalloc	1	0	0	1
jmathai	https://github.com/jmathai	2	0	0	2
jmesnil	https://github.com/jmesnil	1	1	0	2
jmhobbs	https://github.com/jmhobbs	1	0	0	1
jmwolfe	https://github.com/jmwolfe	2	0	0	2
jnugent	https://github.com/jnugent	0	1	0	1
joakimk	https://github.com/joakimk	1	0	0	1
jocelyn	https://github.com/jocelyn	1	1	0	2
joekain	https://github.com/joekain	1	0	0	1
joeriks	https://github.com/joeriks	1	0	0	1
joetsoi	https://github.com/joetsoi	1	0	0	1
joewing	https://github.com/joewing	1	0	0	1
jojenki	https://github.com/jojenki	0	3	0	3
jollyca	https://github.com/jollyca	0	1	0	1
jonobr1	https://github.com/jonobr1	0	1	0	1
jrcloud	https://github.com/jrcloud	0	1	0	1
jreback	https://github.com/jreback	1	1	0	2
jrf0110	https://github.com/jrf0110	1	0	0	1
jricher	https://github.com/jricher	0	10	0	10
jrstear	https://github.com/jrstear	1	0	0	1
jshiell	https://github.com/jshiell	1	0	0	1
jtancil	https://github.com/jtancil	1	1	0	2
jtesser	https://github.com/jtesser	0	1	0	1
jtslear	https://github.com/jtslear	1	0	0	1
juliemr	https://github.com/juliemr	0	1	0	1
julykaz	https://github.com/julykaz	1	0	0	1
jumph4x	https://github.com/jumph4x	0	1	0	1
justinj	https://github.com/justinj	1	0	0	1
juthilo	https://github.com/juthilo	0	1	0	1
jwalton	https://github.com/jwalton	2	0	0	2
jwbober	https://github.com/jwbober	3	0	0	3
jzenzen	https://github.com/jzenzen	1	1	0	2
k3ack3r	https://github.com/k3ack3r	0	1	0	1
kabniel	https://github.com/kabniel	1	0	0	1
kaerumy	https://github.com/kaerumy	1	0	0	1
kantale	https://github.com/kantale	1	0	0	1
kanzure	https://github.com/kanzure	4	3	0	7
kavadas	https://github.com/kavadas	0	1	0	1
kayoub5	https://github.com/kayoub5	1	0	0	1
kbroman	https://github.com/kbroman	1	0	0	1
kelprmy	https://github.com/kelprmy	2	2	0	4
kelvinu	https://github.com/kelvinu	1	0	0	1
kendugu	https://github.com/kendugu	1	0	0	1
kenhkan	https://github.com/kenhkan	0	2	0	2
kenno87	https://github.com/kenno87	6	0	0	6
kepeket	https://github.com/kepeket	1	0	0	1
kfelton	https://github.com/kfelton	2	1	1	4
khazhyk	https://github.com/khazhyk	1	0	0	1
khussey	https://github.com/khussey	1	0	0	1
kikoval	https://github.com/kikoval	1	0	0	1
kilianc	https://github.com/kilianc	1	1	0	2
kiranos	https://github.com/kiranos	1	0	0	1
klausbl	https://github.com/klausbl	1	0	0	1
koheisg	https://github.com/koheisg	1	1	0	2
konekta	https://github.com/konekta	1	0	0	1
koolkao	https://github.com/koolkao	1	0	0	1
koresho	https://github.com/koresho	1	0	0	1
kreotak	https://github.com/kreotak	1	0	0	1
kreven-	https://github.com/kreven-	1	0	0	1
kroepke	https://github.com/kroepke	1	1	0	2
krzyk87	https://github.com/krzyk87	0	2	0	2
kud1ing	https://github.com/kud1ing	1	0	0	1
kvirkki	https://github.com/kvirkki	1	0	0	1
kvngard	https://github.com/kvngard	1	0	0	1
kwijibo	https://github.com/kwijibo	1	0	0	1
larvata	https://github.com/larvata	1	0	0	1
lavelle	https://github.com/lavelle	1	0	0	1
lawnsea	https://github.com/lawnsea	0	2	0	2
ldleman	https://github.com/ldleman	0	0	1	1
lefnire	https://github.com/lefnire	5	1	2	8
legoktm	https://github.com/legoktm	1	0	0	1
leodido	https://github.com/leodido	0	4	0	4
lepetal	https://github.com/lepetal	1	0	0	1
lepture	https://github.com/lepture	1	0	0	1
libardo	https://github.com/libardo	0	1	0	1
ligadao	https://github.com/ligadao	7	1	0	8
ligasgr	https://github.com/ligasgr	0	1	0	1
liuggio	https://github.com/liuggio	0	1	0	1
llasram	https://github.com/llasram	0	1	0	1
lln7777	https://github.com/lln7777	8	1	0	9
lmacken	https://github.com/lmacken	1	0	0	1
luisobo	https://github.com/luisobo	0	1	0	1
lunarok	https://github.com/lunarok	0	1	0	1
lundman	https://github.com/lundman	0	1	0	1
m-stein	https://github.com/m-stein	1	0	0	1
m1entus	https://github.com/m1entus	0	1	0	1
mackief	https://github.com/mackief	0	1	0	1
mackron	https://github.com/mackron	1	0	0	1
madworm	https://github.com/madworm	1	0	0	1
maksimr	https://github.com/maksimr	1	0	0	1
maksudc	https://github.com/maksudc	1	0	0	1
malmaud	https://github.com/malmaud	1	1	0	2
malx122	https://github.com/malx122	1	0	0	1
mandric	https://github.com/mandric	7	2	0	9
manicko	https://github.com/manicko	2	0	0	2
mapkyca	https://github.com/mapkyca	3	1	0	4
maranda	https://github.com/maranda	9	3	0	12
mardink	https://github.com/mardink	0	2	0	2
marijnh	https://github.com/marijnh	0	3	0	3
mariusc	https://github.com/mariusc	6	1	0	7
mathias	https://github.com/mathias	1	0	0	1
matpow2	https://github.com/matpow2	0	1	0	1
mazondo	https://github.com/mazondo	0	1	0	1
mbabker	https://github.com/mbabker	0	1	0	1
mdakota	https://github.com/mdakota	1	0	0	1
mdakram	https://github.com/mdakram	1	0	0	1
mdevils	https://github.com/mdevils	1	1	0	2
mduvall	https://github.com/mduvall	0	2	0	2
mebster	https://github.com/mebster	5	0	0	5
melanke	https://github.com/melanke	0	1	0	1
melrief	https://github.com/melrief	0	1	0	1
mfaizan	https://github.com/mfaizan	2	0	0	2
mghayes	https://github.com/mghayes	1	0	0	1
mgm-oss	https://github.com/mgm-oss	1	1	0	2
mhebing	https://github.com/mhebing	4	0	0	4
mibamur	https://github.com/mibamur	1	0	0	1
mievaan	https://github.com/mievaan	1	0	0	1
mig-hub	https://github.com/mig-hub	1	0	0	1
mike4kz	https://github.com/mike4kz	1	0	0	1
mikymod	https://github.com/mikymod	4	1	0	5
mjangda	https://github.com/mjangda	2	0	0	2
mklooss	https://github.com/mklooss	1	0	0	1
mlimper	https://github.com/mlimper	3	3	0	6
mmmavis	https://github.com/mmmavis	4	4	0	8
mnestis	https://github.com/mnestis	5	3	0	8
mocheng	https://github.com/mocheng	1	0	0	1
modesty	https://github.com/modesty	0	1	0	1
moimael	https://github.com/moimael	1	0	0	1
molnarg	https://github.com/molnarg	1	5	0	6
montchr	https://github.com/montchr	1	3	0	4
mperrin	https://github.com/mperrin	1	0	0	1
mpeshev	https://github.com/mpeshev	1	0	0	1
mpgirro	https://github.com/mpgirro	1	1	0	2
mpontes	https://github.com/mpontes	2	1	0	3
mrapple	https://github.com/mrapple	0	1	0	1
mraulet	https://github.com/mraulet	0	2	0	2
mrgamer	https://github.com/mrgamer	1	0	0	1
mrterry	https://github.com/mrterry	10	2	0	12
mschaaf	https://github.com/mschaaf	11	2	0	13
mscholl	https://github.com/mscholl	0	5	0	5
mstarke	https://github.com/mstarke	0	3	0	3
mtasaka	https://github.com/mtasaka	1	0	0	1
mtwitty	https://github.com/mtwitty	0	1	0	1
muescha	https://github.com/muescha	1	0	0	1
murdoch	https://github.com/murdoch	1	0	0	1
musella	https://github.com/musella	0	2	0	2
mvleroi	https://github.com/mvleroi	1	0	0	1
mw44118	https://github.com/mw44118	1	1	0	2
mwaskom	https://github.com/mwaskom	1	1	0	2
my8bird	https://github.com/my8bird	2	1	0	3
nadolny	https://github.com/nadolny	1	0	0	1
natasab	https://github.com/natasab	3	0	0	3
nbonamy	https://github.com/nbonamy	1	0	0	1
ndunand	https://github.com/ndunand	0	1	0	1
necolas	https://github.com/necolas	0	1	0	1
nerv234	https://github.com/nerv234	0	1	0	1
nesl247	https://github.com/nesl247	1	0	0	1
nethiem	https://github.com/nethiem	1	0	0	1
neumino	https://github.com/neumino	0	1	0	1
nfMalde	https://github.com/nfMalde	3	0	0	3
nikhilm	https://github.com/nikhilm	2	0	0	2
nikmd23	https://github.com/nikmd23	0	14	0	14
nikpapa	https://github.com/nikpapa	1	1	0	2
nikriek	https://github.com/nikriek	2	0	0	2
nilpath	https://github.com/nilpath	1	0	0	1
njsmith	https://github.com/njsmith	0	0	1	1
nkallen	https://github.com/nkallen	0	3	0	3
nodiscc	https://github.com/nodiscc	1	0	0	1
nomosyn	https://github.com/nomosyn	1	0	0	1
notnoop	https://github.com/notnoop	1	0	0	1
nrstott	https://github.com/nrstott	2	1	0	3
nutiteq	https://github.com/nutiteq	0	1	0	1
nykopol	https://github.com/nykopol	1	1	0	2
obsdler	https://github.com/obsdler	1	1	0	2
odewahn	https://github.com/odewahn	9	8	0	17
offiria	https://github.com/offiria	1	6	0	7
oikewll	https://github.com/oikewll	0	2	0	2
olavxxx	https://github.com/olavxxx	1	0	0	1
oldmeat	https://github.com/oldmeat	1	0	0	1
omrihar	https://github.com/omrihar	1	0	0	1
opisano	https://github.com/opisano	0	1	0	1
opuneet	https://github.com/opuneet	0	1	0	1
ornicar	https://github.com/ornicar	0	1	0	1
ostrowr	https://github.com/ostrowr	0	1	0	1
oterral	https://github.com/oterral	0	2	0	2
otiai10	https://github.com/otiai10	4	3	0	7
p7oneer	https://github.com/p7oneer	1	0	0	1
pafelin	https://github.com/pafelin	1	1	0	2
paglias	https://github.com/paglias	3	279	3	285
palkesh	https://github.com/palkesh	1	1	0	2
pazdera	https://github.com/pazdera	1	1	0	2
pcottle	https://github.com/pcottle	0	1	0	1
pdonlon	https://github.com/pdonlon	0	1	0	1
peifang	https://github.com/peifang	1	0	0	1
petru87	https://github.com/petru87	1	0	0	1
pettazz	https://github.com/pettazz	7	7	0	14
pfraces	https://github.com/pfraces	17	0	0	17
pgehres	https://github.com/pgehres	1	0	0	1
pghmcfc	https://github.com/pghmcfc	1	0	0	1
phaidon	https://github.com/phaidon	3	3	0	6
phalcon	https://github.com/phalcon	0	2	0	2
phamann	https://github.com/phamann	0	1	0	1
phansch	https://github.com/phansch	1	6	0	7
phearus	https://github.com/phearus	0	1	0	1
philipn	https://github.com/philipn	1	0	0	1
philips	https://github.com/philips	1	0	0	1
pholser	https://github.com/pholser	0	1	0	1
piuccio	https://github.com/piuccio	2	0	0	2
plajjan	https://github.com/plajjan	2	2	0	4
pltan33	https://github.com/pltan33	1	0	0	1
pnorman	https://github.com/pnorman	2	0	0	2
posativ	https://github.com/posativ	1	1	0	2
postjoe	https://github.com/postjoe	1	0	0	1
prusnak	https://github.com/prusnak	0	1	0	1
puzzo33	https://github.com/puzzo33	1	0	0	1
pvieito	https://github.com/pvieito	1	0	0	1
pwaller	https://github.com/pwaller	1	0	0	1
pwuertz	https://github.com/pwuertz	0	1	0	1
pyprism	https://github.com/pyprism	1	1	0	2
pyricau	https://github.com/pyricau	1	1	0	2
qianshu	https://github.com/qianshu	1	0	0	1
qilicun	https://github.com/qilicun	1	0	0	1
qqchose	https://github.com/qqchose	0	1	0	1
rabasco	https://github.com/rabasco	1	0	0	1
rafaelw	https://github.com/rafaelw	0	6	0	6
raldred	https://github.com/raldred	1	0	0	1
ralsina	https://github.com/ralsina	4	2	1	7
rasvaan	https://github.com/rasvaan	0	1	0	1
rathrio	https://github.com/rathrio	2	0	0	2
rbclark	https://github.com/rbclark	1	0	0	1
rcabamo	https://github.com/rcabamo	0	1	0	1
rcriche	https://github.com/rcriche	1	0	0	1
redthor	https://github.com/redthor	1	0	0	1
reinert	https://github.com/reinert	1	0	0	1
rhenry2	https://github.com/rhenry2	1	0	0	1
rhiokim	https://github.com/rhiokim	1	1	0	2
rhoerbe	https://github.com/rhoerbe	3	0	0	3
rhy-jot	https://github.com/rhy-jot	0	1	0	1
rincedd	https://github.com/rincedd	0	1	0	1
rj03hou	https://github.com/rj03hou	1	1	0	2
rmarcou	https://github.com/rmarcou	1	0	0	1
robblau	https://github.com/robblau	0	1	1	2
robshot	https://github.com/robshot	1	0	0	1
rodanie	https://github.com/rodanie	1	0	0	1
ronrlin	https://github.com/ronrlin	1	0	0	1
rookies	https://github.com/rookies	0	1	0	1
roydude	https://github.com/roydude	7	6	0	13
rperezb	https://github.com/rperezb	1	0	0	1
rsstylr	https://github.com/rsstylr	0	3	0	3
rsyring	https://github.com/rsyring	1	0	0	1
rtrepos	https://github.com/rtrepos	1	0	0	1
rtwomey	https://github.com/rtwomey	0	2	0	2
ryansit	https://github.com/ryansit	1	0	0	1
saas786	https://github.com/saas786	1	0	0	1
saberma	https://github.com/saberma	1	0	0	1
saleiva	https://github.com/saleiva	0	1	0	1
samatdf	https://github.com/samatdf	0	2	0	2
samreid	https://github.com/samreid	2	0	0	2
sanemat	https://github.com/sanemat	1	0	0	1
saschpe	https://github.com/saschpe	1	0	0	1
sbenito	https://github.com/sbenito	0	2	0	2
sbisbee	https://github.com/sbisbee	0	1	0	1
sbordes	https://github.com/sbordes	0	1	0	1
scaloni	https://github.com/scaloni	0	1	0	1
scambra	https://github.com/scambra	0	2	0	2
schafik	https://github.com/schafik	1	0	0	1
schulze	https://github.com/schulze	1	0	0	1
schwern	https://github.com/schwern	1	1	0	2
scopatz	https://github.com/scopatz	2	1	0	3
scottle	https://github.com/scottle	1	0	0	1
sdcsyyg	https://github.com/sdcsyyg	1	0	1	2
sdhouib	https://github.com/sdhouib	1	0	0	1
seaders	https://github.com/seaders	1	0	0	1
seandst	https://github.com/seandst	1	0	0	1
segabor	https://github.com/segabor	2	0	0	2
selvakn	https://github.com/selvakn	1	0	0	1
seratch	https://github.com/seratch	1	0	0	1
sgratzl	https://github.com/sgratzl	0	3	0	3
shahata	https://github.com/shahata	1	0	0	1
shamrin	https://github.com/shamrin	0	1	0	1
shihaow	https://github.com/shihaow	0	1	0	1
shlonny	https://github.com/shlonny	0	1	0	1
shoheik	https://github.com/shoheik	3	0	0	3
simar88	https://github.com/simar88	1	0	0	1
simurai	https://github.com/simurai	1	0	0	1
sirazor	https://github.com/sirazor	1	0	0	1
sitegui	https://github.com/sitegui	2	0	0	2
sjmiles	https://github.com/sjmiles	3	2	0	5
skariel	https://github.com/skariel	6	0	0	6
skiadas	https://github.com/skiadas	1	0	0	1
skiptag	https://github.com/skiptag	2	0	0	2
skuroda	https://github.com/skuroda	0	1	0	1
skywave	https://github.com/skywave	1	0	0	1
slaFFik	https://github.com/slaFFik	0	2	0	2
slayton	https://github.com/slayton	1	0	0	1
slisson	https://github.com/slisson	0	3	0	3
smilack	https://github.com/smilack	1	0	0	1
smimram	https://github.com/smimram	0	1	0	1
smithkm	https://github.com/smithkm	1	0	0	1
sobi3ch	https://github.com/sobi3ch	1	0	0	1
solarce	https://github.com/solarce	1	0	0	1
solosky	https://github.com/solosky	1	0	0	1
solussd	https://github.com/solussd	1	0	0	1
songgao	https://github.com/songgao	1	0	0	1
soonick	https://github.com/soonick	0	1	0	1
sorbits	https://github.com/sorbits	0	2	0	2
sorvell	https://github.com/sorvell	3	2	0	5
srimarc	https://github.com/srimarc	0	1	0	1
ssclark	https://github.com/ssclark	1	0	0	1
sshwsfc	https://github.com/sshwsfc	0	1	0	1
sskhiri	https://github.com/sskhiri	0	1	0	1
stakats	https://github.com/stakats	1	0	0	1
stakkit	https://github.com/stakkit	1	0	0	1
steffan	https://github.com/steffan	1	0	0	1
steffex	https://github.com/steffex	1	0	0	1
stenyak	https://github.com/stenyak	0	1	0	1
steve71	https://github.com/steve71	0	1	0	1
steveoh	https://github.com/steveoh	2	0	0	2
steveww	https://github.com/steveww	1	0	0	1
stijink	https://github.com/stijink	1	0	0	1
stoskov	https://github.com/stoskov	1	0	0	1
stumpdk	https://github.com/stumpdk	1	1	1	3
subhaze	https://github.com/subhaze	0	1	0	1
sum2012	https://github.com/sum2012	1	0	0	1
suresho	https://github.com/suresho	1	1	0	2
sv3tli0	https://github.com/sv3tli0	1	0	0	1
svivian	https://github.com/svivian	0	1	0	1
swegner	https://github.com/swegner	1	0	0	1
swrobel	https://github.com/swrobel	0	1	0	1
szabgab	https://github.com/szabgab	18	3	0	21
szanati	https://github.com/szanati	1	1	0	2
tanghus	https://github.com/tanghus	0	2	0	2
tardate	https://github.com/tardate	1	0	0	1
taro801	https://github.com/taro801	1	0	0	1
tdreyno	https://github.com/tdreyno	0	1	0	1
techhat	https://github.com/techhat	0	1	0	1
tekeiro	https://github.com/tekeiro	7	0	0	7
teoking	https://github.com/teoking	2	0	0	2
teppeis	https://github.com/teppeis	1	0	0	1
tgjones	https://github.com/tgjones	1	3	0	4
thakyuu	https://github.com/thakyuu	1	0	0	1
tharris	https://github.com/tharris	0	3	0	3
thaxter	https://github.com/thaxter	1	0	0	1
theaxel	https://github.com/theaxel	0	1	0	1
theroux	https://github.com/theroux	1	0	0	1
thinxer	https://github.com/thinxer	1	0	0	1
thonixx	https://github.com/thonixx	2	4	0	6
tidoust	https://github.com/tidoust	0	2	0	2
tiennou	https://github.com/tiennou	1	0	0	1
tilgovi	https://github.com/tilgovi	1	2	0	3
timur87	https://github.com/timur87	1	0	0	1
titulus	https://github.com/titulus	1	0	0	1
tjuerge	https://github.com/tjuerge	2	2	1	5
tleyden	https://github.com/tleyden	0	1	0	1
tmichel	https://github.com/tmichel	0	1	0	1
tmuguet	https://github.com/tmuguet	0	1	0	1
tocjack	https://github.com/tocjack	0	17	0	17
tojonmz	https://github.com/tojonmz	1	1	0	2
tombell	https://github.com/tombell	0	1	0	1
tonivdv	https://github.com/tonivdv	1	1	0	2
torgeha	https://github.com/torgeha	1	0	0	1
torgock	https://github.com/torgock	1	0	0	1
torinfo	https://github.com/torinfo	7	0	0	7
torre76	https://github.com/torre76	1	0	0	1
toto976	https://github.com/toto976	1	0	0	1
trastle	https://github.com/trastle	1	0	0	1
travisp	https://github.com/travisp	1	0	0	1
trincer	https://github.com/trincer	1	0	0	1
trustin	https://github.com/trustin	3	0	0	3
tsalmon	https://github.com/tsalmon	2	1	0	3
tschaub	https://github.com/tschaub	1	0	0	1
tsenart	https://github.com/tsenart	4	0	0	4
tshead2	https://github.com/tshead2	3	2	0	5
tuctboh	https://github.com/tuctboh	1	0	0	1
tvdeyen	https://github.com/tvdeyen	1	0	0	1
tweek82	https://github.com/tweek82	1	0	0	1
twittem	https://github.com/twittem	0	1	0	1
twpayne	https://github.com/twpayne	1	0	0	1
uGoMobi	https://github.com/uGoMobi	0	1	0	1
ubruhin	https://github.com/ubruhin	1	0	0	1
ujentus	https://github.com/ujentus	2	0	0	2
uksus70	https://github.com/uksus70	2	1	0	3
utumdol	https://github.com/utumdol	2	1	0	3
vainzki	https://github.com/vainzki	1	0	0	1
vedmack	https://github.com/vedmack	0	1	0	1
vincent	https://github.com/vincent	2	0	0	2
visualJ	https://github.com/visualJ	0	1	0	1
vmalloc	https://github.com/vmalloc	1	3	0	4
vovan22	https://github.com/vovan22	1	0	0	1
vrabaud	https://github.com/vrabaud	0	1	1	2
vstoyak	https://github.com/vstoyak	1	0	0	1
vtjnash	https://github.com/vtjnash	1	2	0	3
wasabiz	https://github.com/wasabiz	2	0	0	2
wbrenna	https://github.com/wbrenna	4	2	0	6
wdahdul	https://github.com/wdahdul	1	0	0	1
webbird	https://github.com/webbird	1	1	0	2
wesky93	https://github.com/wesky93	3	5	0	8
wfxjeff	https://github.com/wfxjeff	1	0	0	1
whbaker	https://github.com/whbaker	0	2	0	2
whimboo	https://github.com/whimboo	1	2	0	3
whit537	https://github.com/whit537	2	2	0	4
whitemx	https://github.com/whitemx	0	1	0	1
wieshka	https://github.com/wieshka	1	0	0	1
willnet	https://github.com/willnet	0	1	0	1
wltsmrz	https://github.com/wltsmrz	0	2	1	3
wojsmol	https://github.com/wojsmol	1	0	0	1
wolever	https://github.com/wolever	2	1	0	3
wongelz	https://github.com/wongelz	1	0	0	1
woodbri	https://github.com/woodbri	3	3	0	6
wsantos	https://github.com/wsantos	2	0	0	2
wuxue11	https://github.com/wuxue11	1	0	0	1
xFeintx	https://github.com/xFeintx	1	0	0	1
xavijam	https://github.com/xavijam	1	0	0	1
xeolabs	https://github.com/xeolabs	0	1	0	1
xhacker	https://github.com/xhacker	0	1	0	1
xiang82	https://github.com/xiang82	1	0	0	1
xnjiang	https://github.com/xnjiang	1	0	0	1
xquezme	https://github.com/xquezme	0	1	0	1
xraynt8	https://github.com/xraynt8	1	0	0	1
xtra-be	https://github.com/xtra-be	1	0	0	1
xurubin	https://github.com/xurubin	0	1	0	1
xwolfde	https://github.com/xwolfde	0	1	0	1
y-lohse	https://github.com/y-lohse	3	0	0	3
yeukhon	https://github.com/yeukhon	0	2	0	2
ylovesy	https://github.com/ylovesy	1	0	0	1
ymendel	https://github.com/ymendel	0	1	0	1
yokolet	https://github.com/yokolet	1	0	0	1
yongwen	https://github.com/yongwen	0	1	0	1
yourabi	https://github.com/yourabi	1	0	0	1
yushiro	https://github.com/yushiro	1	0	0	1
zambrey	https://github.com/zambrey	0	1	0	1
zar0ku1	https://github.com/zar0ku1	1	0	0	1
zhanglc	https://github.com/zhanglc	1	1	0	2
zml2008	https://github.com/zml2008	1	3	0	4
zmughal	https://github.com/zmughal	2	0	0	2
zonkzen	https://github.com/zonkzen	1	0	0	1
zvikara	https://github.com/zvikara	1	0	0	1
0JammieO	https://github.com/0JammieO	1	0	0	1
23Skidoo	https://github.com/23Skidoo	0	2	1	3
4ndr01d3	https://github.com/4ndr01d3	1	0	0	1
97torvic	https://github.com/97torvic	1	0	0	1
Alekhios	https://github.com/Alekhios	3	0	0	3
AlexLuya	https://github.com/AlexLuya	0	1	0	1
AlexMost	https://github.com/AlexMost	1	0	0	1
AlfredSK	https://github.com/AlfredSK	1	0	0	1
AlphaGit	https://github.com/AlphaGit	1	0	0	1
AteqEjaz	https://github.com/AteqEjaz	0	1	0	1
Atheros1	https://github.com/Atheros1	0	1	0	1
Axiverse	https://github.com/Axiverse	1	0	0	1
BStramke	https://github.com/BStramke	1	0	0	1
Bregaida	https://github.com/Bregaida	0	3	0	3
Byronlee	https://github.com/Byronlee	5	0	0	5
Cervator	https://github.com/Cervator	1	4	0	5
Chabrier	https://github.com/Chabrier	0	2	0	2
Chandler	https://github.com/Chandler	4	5	1	10
Cheeseen	https://github.com/Cheeseen	0	1	0	1
Chris---	https://github.com/Chris---	0	1	0	1
ChrisK91	https://github.com/ChrisK91	2	0	0	2
Chrisseh	https://github.com/Chrisseh	1	0	0	1
Claycorp	https://github.com/Claycorp	1	0	0	1
CoachTom	https://github.com/CoachTom	1	0	0	1
Codebryo	https://github.com/Codebryo	0	1	0	1
CrabDude	https://github.com/CrabDude	0	2	0	2
Cyril-sf	https://github.com/Cyril-sf	0	1	0	1
DaegiKim	https://github.com/DaegiKim	1	0	0	1
DaniHaag	https://github.com/DaniHaag	1	0	0	1
DarioMag	https://github.com/DarioMag	0	1	0	1
Dasich84	https://github.com/Dasich84	1	0	0	1
DerGeras	https://github.com/DerGeras	0	1	0	1
DezerteR	https://github.com/DezerteR	1	0	0	1
Dieterbe	https://github.com/Dieterbe	1	0	0	1
Draco18s	https://github.com/Draco18s	1	0	0	1
Dworzaaa	https://github.com/Dworzaaa	15	9	0	24
EvanHahn	https://github.com/EvanHahn	2	0	0	2
F4NT4SM4	https://github.com/F4NT4SM4	1	1	0	2
Finkregh	https://github.com/Finkregh	1	0	0	1
Flex1911	https://github.com/Flex1911	1	0	0	1
Florenze	https://github.com/Florenze	0	1	1	2
G-Square	https://github.com/G-Square	1	0	0	1
GCrossen	https://github.com/GCrossen	2	0	0	2
Garfielt	https://github.com/Garfielt	0	2	0	2
GermainZ	https://github.com/GermainZ	1	0	0	1
GinaRare	https://github.com/GinaRare	1	0	0	1
Gizburdt	https://github.com/Gizburdt	0	1	0	1
Gtjw3110	https://github.com/Gtjw3110	1	0	0	1
HaNdTriX	https://github.com/HaNdTriX	1	0	0	1
HosipLan	https://github.com/HosipLan	3	3	0	6
IceskYsl	https://github.com/IceskYsl	0	1	0	1
Ineentho	https://github.com/Ineentho	1	0	0	1
IonSwitz	https://github.com/IonSwitz	1	0	0	1
IrlJidel	https://github.com/IrlJidel	1	0	0	1
IsaiahvH	https://github.com/IsaiahvH	1	0	0	1
ItsHarry	https://github.com/ItsHarry	0	1	0	1
JVeerman	https://github.com/JVeerman	10	3	0	13
JaviSoto	https://github.com/JaviSoto	1	0	0	1
JenMysoc	https://github.com/JenMysoc	2	0	0	2
Jerry793	https://github.com/Jerry793	1	0	0	1
Jonasvsl	https://github.com/Jonasvsl	1	0	0	1
Jonovono	https://github.com/Jonovono	1	0	0	1
Jonty800	https://github.com/Jonty800	0	1	0	1
JuFrolov	https://github.com/JuFrolov	1	0	0	1
KarlPurk	https://github.com/KarlPurk	1	0	0	1
KhanBugz	https://github.com/KhanBugz	681	11267	0	11948
Khubajsn	https://github.com/Khubajsn	2	0	0	2
Kolyasya	https://github.com/Kolyasya	1	0	0	1
Kwpolska	https://github.com/Kwpolska	1	1	0	2
LArchaon	https://github.com/LArchaon	1	0	0	1
Laremere	https://github.com/Laremere	1	0	0	1
Lawouach	https://github.com/Lawouach	1	1	0	2
LexManos	https://github.com/LexManos	0	1	0	1
LisaHelm	https://github.com/LisaHelm	18	0	0	18
Lordmau5	https://github.com/Lordmau5	1	0	0	1
MAKIO135	https://github.com/MAKIO135	1	1	0	2
MJTheOne	https://github.com/MJTheOne	1	0	0	1
Mahopacs	https://github.com/Mahopacs	4	3	0	7
Malphage	https://github.com/Malphage	1	0	0	1
MarshalW	https://github.com/MarshalW	1	0	0	1
MartijnR	https://github.com/MartijnR	7	11	0	18
MartinJJ	https://github.com/MartinJJ	1	0	0	1
Maxxgold	https://github.com/Maxxgold	2	0	0	2
Mezgrman	https://github.com/Mezgrman	0	1	0	1
Mikimoto	https://github.com/Mikimoto	1	0	0	1
Mouvedia	https://github.com/Mouvedia	2	0	0	2
Mpdreamz	https://github.com/Mpdreamz	0	1	0	1
Mr-Cutia	https://github.com/Mr-Cutia	1	0	0	1
MrKeiKun	https://github.com/MrKeiKun	1	0	0	1
Nebelhom	https://github.com/Nebelhom	5	2	0	7
Nimrodda	https://github.com/Nimrodda	0	3	0	3
Octonami	https://github.com/Octonami	0	1	0	1
Omertron	https://github.com/Omertron	0	1	0	1
Omicron7	https://github.com/Omicron7	1	0	0	1
PLEEROCK	https://github.com/PLEEROCK	1	0	0	1
Pankaj03	https://github.com/Pankaj03	1	1	0	2
Parkayun	https://github.com/Parkayun	1	0	0	1
Partysun	https://github.com/Partysun	1	0	0	1
ProLoser	https://github.com/ProLoser	6	2	0	8
Provoker	https://github.com/Provoker	0	2	0	2
Pvlerick	https://github.com/Pvlerick	1	3	0	4
RPSource	https://github.com/RPSource	3	1	0	4
RadoRado	https://github.com/RadoRado	1	0	0	1
RafScrat	https://github.com/RafScrat	1	0	0	1
RickMohr	https://github.com/RickMohr	3	0	0	3
Rjonhson	https://github.com/Rjonhson	2	0	0	2
RobDolin	https://github.com/RobDolin	1	0	0	1
RochaTSI	https://github.com/RochaTSI	0	1	0	1
Ryochan7	https://github.com/Ryochan7	0	1	0	1
Ryotsuke	https://github.com/Ryotsuke	1	1	0	2
SAPlayer	https://github.com/SAPlayer	2	2	0	4
SabreCat	https://github.com/SabreCat	2	1	2	5
SamMousa	https://github.com/SamMousa	1	0	0	1
ScotterC	https://github.com/ScotterC	1	0	0	1
SethosII	https://github.com/SethosII	2	1	0	3
Shadowss	https://github.com/Shadowss	1	2	0	3
ShengYun	https://github.com/ShengYun	1	1	0	2
Shmiddty	https://github.com/Shmiddty	1	0	0	1
Sideways	https://github.com/Sideways	0	1	1	2
SimSonic	https://github.com/SimSonic	0	1	0	1
SimonRen	https://github.com/SimonRen	1	0	0	1
SirCmpwn	https://github.com/SirCmpwn	0	1	0	1
Squareys	https://github.com/Squareys	1	1	0	2
Stibbons	https://github.com/Stibbons	1	0	0	1
Strilanc	https://github.com/Strilanc	2	0	0	2
Syncness	https://github.com/Syncness	1	0	0	1
TReische	https://github.com/TReische	3	0	0	3
Temechon	https://github.com/Temechon	0	1	0	1
The-Craw	https://github.com/The-Craw	1	0	0	1
TimWolla	https://github.com/TimWolla	1	1	0	2
Timandes	https://github.com/Timandes	3	0	0	3
TingPing	https://github.com/TingPing	0	1	0	1
TomyLobo	https://github.com/TomyLobo	0	0	1	1
Tonkpils	https://github.com/Tonkpils	0	1	0	1
Tristan-	https://github.com/Tristan-	1	0	0	1
Tsukanov	https://github.com/Tsukanov	2	1	0	3
UberDrey	https://github.com/UberDrey	1	0	0	1
Uncommon	https://github.com/Uncommon	1	0	0	1
Uzair187	https://github.com/Uzair187	1	0	0	1
Valloric	https://github.com/Valloric	0	2	0	2
Wilee999	https://github.com/Wilee999	1	0	0	1
Xandaros	https://github.com/Xandaros	0	1	0	1
Zardoz89	https://github.com/Zardoz89	0	1	0	1
Zhanelya	https://github.com/Zhanelya	1	2	0	3
abeaumet	https://github.com/abeaumet	1	0	0	1
abstiles	https://github.com/abstiles	1	0	0	1
acuarium	https://github.com/acuarium	1	0	0	1
adamblan	https://github.com/adamblan	0	3	0	3
aepsil0n	https://github.com/aepsil0n	0	1	0	1
agladysh	https://github.com/agladysh	1	0	0	1
ahendrix	https://github.com/ahendrix	156	90	0	246
ahuang13	https://github.com/ahuang13	0	1	0	1
ahyangyi	https://github.com/ahyangyi	1	0	0	1
aiannacc	https://github.com/aiannacc	0	1	0	1
akalicki	https://github.com/akalicki	0	2	0	2
alantouk	https://github.com/alantouk	1	0	0	1
albus522	https://github.com/albus522	0	1	0	1
alecswan	https://github.com/alecswan	1	0	0	1
alexeycv	https://github.com/alexeycv	1	1	0	2
alexeymo	https://github.com/alexeymo	2	0	0	2
alexfoxy	https://github.com/alexfoxy	1	1	0	2
alexkent	https://github.com/alexkent	1	0	0	1
algernon	https://github.com/algernon	0	1	0	1
alneberg	https://github.com/alneberg	1	1	0	2
alpennec	https://github.com/alpennec	0	1	0	1
alunduil	https://github.com/alunduil	4	0	0	4
amaltson	https://github.com/amaltson	1	0	0	1
amitaibu	https://github.com/amitaibu	1	3	0	4
andersje	https://github.com/andersje	1	0	0	1
andrew13	https://github.com/andrew13	0	1	0	1
andy4711	https://github.com/andy4711	1	0	0	1
andyhall	https://github.com/andyhall	0	1	0	1
andytuba	https://github.com/andytuba	0	1	0	1
aneeshpu	https://github.com/aneeshpu	3	1	0	4
annlabv3	https://github.com/annlabv3	1	0	0	1
antonio0	https://github.com/antonio0	1	0	0	1
aortbals	https://github.com/aortbals	0	3	0	3
apobbati	https://github.com/apobbati	1	0	0	1
aporo001	https://github.com/aporo001	1	0	0	1
applemcg	https://github.com/applemcg	0	1	0	1
applezqp	https://github.com/applezqp	1	0	0	1
appliqed	https://github.com/appliqed	1	0	0	1
apratina	https://github.com/apratina	2	1	0	3
arantius	https://github.com/arantius	0	2	0	2
ardderrk	https://github.com/ardderrk	0	1	0	1
ardiwine	https://github.com/ardiwine	1	0	0	1
areynold	https://github.com/areynold	11	0	0	11
ariddell	https://github.com/ariddell	1	0	0	1
ariesjia	https://github.com/ariesjia	1	0	0	1
arilishu	https://github.com/arilishu	1	0	0	1
arjclark	https://github.com/arjclark	0	1	0	1
arpowers	https://github.com/arpowers	0	2	0	2
arstrube	https://github.com/arstrube	1	0	0	1
arthur-e	https://github.com/arthur-e	1	0	0	1
arthurnn	https://github.com/arthurnn	0	1	0	1
aruijmen	https://github.com/aruijmen	1	2	0	3
arusahni	https://github.com/arusahni	0	3	0	3
aschempp	https://github.com/aschempp	3	1	0	4
ashwinsa	https://github.com/ashwinsa	2	0	0	2
astatham	https://github.com/astatham	1	0	0	1
atesoglu	https://github.com/atesoglu	1	1	0	2
azturner	https://github.com/azturner	0	1	0	1
babelduo	https://github.com/babelduo	0	1	0	1
balupton	https://github.com/balupton	2	0	0	2
bcardiff	https://github.com/bcardiff	0	1	0	1
bcharles	https://github.com/bcharles	2	0	0	2
bcipolli	https://github.com/bcipolli	2	0	0	2
beireken	https://github.com/beireken	1	0	0	1
benglass	https://github.com/benglass	1	0	0	1
benhanzl	https://github.com/benhanzl	0	1	0	1
benoit-l	https://github.com/benoit-l	1	0	0	1
bensterd	https://github.com/bensterd	1	0	0	1
bergmark	https://github.com/bergmark	1	0	0	1
bfriesen	https://github.com/bfriesen	2	1	0	3
bgilbert	https://github.com/bgilbert	0	1	0	1
bheavner	https://github.com/bheavner	1	0	0	1
biffbyrd	https://github.com/biffbyrd	2	3	0	5
billygoo	https://github.com/billygoo	1	0	0	1
bkardell	https://github.com/bkardell	1	1	0	2
bkingery	https://github.com/bkingery	0	3	0	3
blackzky	https://github.com/blackzky	1	0	0	1
bmcbride	https://github.com/bmcbride	1	0	0	1
bmsengin	https://github.com/bmsengin	1	0	0	1
bmueller	https://github.com/bmueller	1	0	0	1
bnmurphy	https://github.com/bnmurphy	1	1	0	2
bohansen	https://github.com/bohansen	0	1	0	1
bollwyvl	https://github.com/bollwyvl	2	0	0	2
bomakalu	https://github.com/bomakalu	1	0	0	1
bool-rus	https://github.com/bool-rus	1	1	0	2
boothead	https://github.com/boothead	1	0	0	1
bornakke	https://github.com/bornakke	1	0	0	1
brabidou	https://github.com/brabidou	0	1	1	2
brain1ac	https://github.com/brain1ac	31	0	0	31
breversa	https://github.com/breversa	1	0	0	1
brotatos	https://github.com/brotatos	0	1	0	1
browndav	https://github.com/browndav	1	0	0	1
bsweeney	https://github.com/bsweeney	0	1	0	1
bwbecker	https://github.com/bwbecker	1	0	0	1
bworrell	https://github.com/bworrell	2	0	0	2
canburak	https://github.com/canburak	1	0	0	1
carina21	https://github.com/carina21	2	0	0	2
cboettig	https://github.com/cboettig	0	4	0	4
cchantep	https://github.com/cchantep	5	6	0	11
cconover	https://github.com/cconover	1	0	0	1
ccristal	https://github.com/ccristal	1	0	0	1
cdmiller	https://github.com/cdmiller	2	1	0	3
cestivan	https://github.com/cestivan	1	0	0	1
chao0038	https://github.com/chao0038	1	1	0	2
chat4pak	https://github.com/chat4pak	1	0	0	1
chenshun	https://github.com/chenshun	0	1	0	1
chibisov	https://github.com/chibisov	0	1	0	1
chris-82	https://github.com/chris-82	1	0	0	1
chrish42	https://github.com/chrish42	1	0	0	1
chylvina	https://github.com/chylvina	1	0	0	1
ciph3rIT	https://github.com/ciph3rIT	0	1	0	1
cjmcgraw	https://github.com/cjmcgraw	1	4	0	5
cjoelrun	https://github.com/cjoelrun	1	0	0	1
clammy77	https://github.com/clammy77	1	0	0	1
clicordi	https://github.com/clicordi	0	3	0	3
cmungall	https://github.com/cmungall	1	2	0	3
cobattle	https://github.com/cobattle	1	0	0	1
coleifer	https://github.com/coleifer	0	2	0	2
colincgn	https://github.com/colincgn	0	1	1	2
consindo	https://github.com/consindo	1	0	0	1
cordoval	https://github.com/cordoval	1	1	0	2
cournape	https://github.com/cournape	1	0	0	1
cpanxaoc	https://github.com/cpanxaoc	0	1	0	1
cpettitt	https://github.com/cpettitt	5	1	0	6
craftyuk	https://github.com/craftyuk	0	1	0	1
crazy2be	https://github.com/crazy2be	1	0	0	1
creepone	https://github.com/creepone	1	0	0	1
creswick	https://github.com/creswick	1	0	0	1
croensch	https://github.com/croensch	1	0	0	1
csgordon	https://github.com/csgordon	1	0	0	1
cvrebert	https://github.com/cvrebert	1	3	0	4
cwensley	https://github.com/cwensley	1	1	0	2
cyfdecyf	https://github.com/cyfdecyf	0	2	0	2
d10genes	https://github.com/d10genes	1	0	0	1
daGrevis	https://github.com/daGrevis	3	7	0	10
dadoonet	https://github.com/dadoonet	0	1	0	1
daekrist	https://github.com/daekrist	1	0	0	1
daimajia	https://github.com/daimajia	1	0	0	1
dalerank	https://github.com/dalerank	0	1	0	1
daliwali	https://github.com/daliwali	1	0	0	1
danhorst	https://github.com/danhorst	2	1	0	3
daniel-g	https://github.com/daniel-g	2	0	0	2
danlurie	https://github.com/danlurie	0	1	0	1
danmayer	https://github.com/danmayer	0	1	0	1
dannys42	https://github.com/dannys42	1	0	0	1
daraeman	https://github.com/daraeman	3	2	0	5
dasickis	https://github.com/dasickis	5	0	0	5
dat97mae	https://github.com/dat97mae	2	1	0	3
dave8401	https://github.com/dave8401	1	0	0	1
daveeloo	https://github.com/daveeloo	3	0	0	3
davehunt	https://github.com/davehunt	1	0	0	1
davelab6	https://github.com/davelab6	1	4	0	5
davereid	https://github.com/davereid	1	1	0	2
davetoxa	https://github.com/davetoxa	0	6	0	6
dbudunov	https://github.com/dbudunov	0	2	0	2
dcransac	https://github.com/dcransac	1	0	0	1
dealproc	https://github.com/dealproc	1	0	0	1
decitrig	https://github.com/decitrig	0	1	0	1
deepwell	https://github.com/deepwell	1	0	0	1
demarius	https://github.com/demarius	0	4	0	4
demonkit	https://github.com/demonkit	1	0	0	1
desimone	https://github.com/desimone	1	0	0	1
detonyle	https://github.com/detonyle	1	0	0	1
devproof	https://github.com/devproof	0	1	0	1
deweller	https://github.com/deweller	1	2	0	3
dfanchon	https://github.com/dfanchon	1	0	0	1
dhead666	https://github.com/dhead666	0	1	0	1
diego898	https://github.com/diego898	1	0	0	1
diegoeis	https://github.com/diegoeis	0	3	0	3
diestrin	https://github.com/diestrin	1	0	0	1
dimka665	https://github.com/dimka665	1	0	0	1
dipievil	https://github.com/dipievil	4	2	0	6
distanlo	https://github.com/distanlo	1	0	0	1
djaccard	https://github.com/djaccard	15	0	0	15
djberg96	https://github.com/djberg96	2	0	0	2
djhaynes	https://github.com/djhaynes	0	4	0	4
djvirgen	https://github.com/djvirgen	0	1	0	1
dlai0001	https://github.com/dlai0001	0	1	0	1
dmazzoni	https://github.com/dmazzoni	2	5	0	7
dmcassel	https://github.com/dmcassel	3	1	0	4
dmitriid	https://github.com/dmitriid	3	0	0	3
dmitrykx	https://github.com/dmitrykx	1	0	0	1
dodtsair	https://github.com/dodtsair	1	0	0	1
dominikh	https://github.com/dominikh	0	0	1	1
domoritz	https://github.com/domoritz	0	2	1	3
dotch987	https://github.com/dotch987	1	0	0	1
dparrish	https://github.com/dparrish	1	0	0	1
dpenezic	https://github.com/dpenezic	1	0	0	1
dpletter	https://github.com/dpletter	1	0	0	1
dpoirier	https://github.com/dpoirier	4	3	0	7
dreamnet	https://github.com/dreamnet	9	0	1	10
drhenner	https://github.com/drhenner	1	0	0	1
dtgeorge	https://github.com/dtgeorge	0	1	0	1
dvlasenk	https://github.com/dvlasenk	1	0	0	1
ebruchez	https://github.com/ebruchez	3	1	0	4
edencore	https://github.com/edencore	1	0	0	1
egmolina	https://github.com/egmolina	1	1	0	2
egrachev	https://github.com/egrachev	1	0	0	1
ehaughee	https://github.com/ehaughee	2	3	0	5
ehazlett	https://github.com/ehazlett	1	1	0	2
eigenein	https://github.com/eigenein	5	6	0	11
eknight7	https://github.com/eknight7	2	0	0	2
elemoine	https://github.com/elemoine	0	1	1	2
ellisium	https://github.com/ellisium	2	0	0	2
emilisto	https://github.com/emilisto	1	0	0	1
emmanuel	https://github.com/emmanuel	1	0	0	1
enriquez	https://github.com/enriquez	0	1	0	1
erbbysam	https://github.com/erbbysam	3	0	0	3
ericjang	https://github.com/ericjang	1	0	0	1
ericmann	https://github.com/ericmann	0	1	0	1
erikrose	https://github.com/erikrose	2	0	0	2
eschulte	https://github.com/eschulte	1	0	0	1
escobar5	https://github.com/escobar5	1	0	0	1
espertus	https://github.com/espertus	1	0	0	1
evilhero	https://github.com/evilhero	0	61	0	61
evyatron	https://github.com/evyatron	0	2	0	2
exitsoft	https://github.com/exitsoft	0	1	0	1
eziosoft	https://github.com/eziosoft	0	2	0	2
ezzatron	https://github.com/ezzatron	3	0	0	3
fallback	https://github.com/fallback	1	0	0	1
fchris82	https://github.com/fchris82	1	0	0	1
fedobear	https://github.com/fedobear	1	0	0	1
felipepx	https://github.com/felipepx	1	0	0	1
fenixkim	https://github.com/fenixkim	1	0	0	1
festaans	https://github.com/festaans	1	0	0	1
fffonion	https://github.com/fffonion	1	0	0	1
fgiannar	https://github.com/fgiannar	3	0	0	3
fjarrett	https://github.com/fjarrett	0	1	0	1
flacunza	https://github.com/flacunza	1	0	0	1
flaviojr	https://github.com/flaviojr	3	0	0	3
fleeting	https://github.com/fleeting	0	1	1	2
flgcloud	https://github.com/flgcloud	2	0	0	2
folletto	https://github.com/folletto	0	1	0	1
forresto	https://github.com/forresto	1	0	0	1
foxbunny	https://github.com/foxbunny	1	0	0	1
foxer-zt	https://github.com/foxer-zt	0	3	0	3
fqrouter	https://github.com/fqrouter	0	2	0	2
fraywing	https://github.com/fraywing	0	1	1	2
frbayart	https://github.com/frbayart	1	0	0	1
fronteed	https://github.com/fronteed	1	1	0	2
fschlich	https://github.com/fschlich	1	0	0	1
furgalep	https://github.com/furgalep	0	1	0	1
fwbrasil	https://github.com/fwbrasil	0	1	0	1
gFreezer	https://github.com/gFreezer	2	1	0	3
garnertb	https://github.com/garnertb	0	1	0	1
garyburd	https://github.com/garyburd	0	1	0	1
gaspacho	https://github.com/gaspacho	1	0	0	1
gaydenko	https://github.com/gaydenko	2	0	0	2
geoderek	https://github.com/geoderek	0	1	1	2
gewisser	https://github.com/gewisser	1	0	0	1
gfarrell	https://github.com/gfarrell	1	0	0	1
ggoodman	https://github.com/ggoodman	0	1	0	1
gjenkins	https://github.com/gjenkins	1	0	0	1
glaanc03	https://github.com/glaanc03	0	1	0	1
glayyiyi	https://github.com/glayyiyi	1	0	0	1
gnowland	https://github.com/gnowland	1	0	0	1
goldingn	https://github.com/goldingn	0	2	0	2
goldmann	https://github.com/goldmann	1	0	0	1
golfarid	https://github.com/golfarid	0	6	0	6
goodsign	https://github.com/goodsign	0	1	0	1
gosyujin	https://github.com/gosyujin	3	0	0	3
grandrew	https://github.com/grandrew	1	7	0	8
greergan	https://github.com/greergan	1	0	0	1
greg0ire	https://github.com/greg0ire	1	1	0	2
greggles	https://github.com/greggles	1	0	0	1
gregrice	https://github.com/gregrice	3	1	0	4
grepwood	https://github.com/grepwood	1	0	0	1
grindars	https://github.com/grindars	1	0	0	1
gsantome	https://github.com/gsantome	1	0	0	1
gsingh93	https://github.com/gsingh93	1	0	0	1
gsobczyk	https://github.com/gsobczyk	1	1	0	2
gurupras	https://github.com/gurupras	2	1	0	3
gwaldron	https://github.com/gwaldron	1	1	0	2
haliphax	https://github.com/haliphax	1	0	0	1
hall5714	https://github.com/hall5714	2	3	0	5
halr9000	https://github.com/halr9000	1	0	0	1
hanikesn	https://github.com/hanikesn	1	0	0	1
hannosch	https://github.com/hannosch	2	0	0	2
hansgill	https://github.com/hansgill	1	1	0	2
harmscon	https://github.com/harmscon	1	0	0	1
hautonjt	https://github.com/hautonjt	2	3	0	5
hazirguo	https://github.com/hazirguo	3	2	0	5
hd-deman	https://github.com/hd-deman	1	1	0	2
hehafner	https://github.com/hehafner	1	0	0	1
helirexi	https://github.com/helirexi	1	0	0	1
hellerst	https://github.com/hellerst	1	0	0	1
hennekec	https://github.com/hennekec	1	0	0	1
herzbube	https://github.com/herzbube	6	2	0	8
heystack	https://github.com/heystack	1	0	0	1
hijarian	https://github.com/hijarian	0	2	0	2
himmel22	https://github.com/himmel22	0	4	0	4
hishamhm	https://github.com/hishamhm	0	0	1	1
hisohito	https://github.com/hisohito	1	0	0	1
hitwhwlj	https://github.com/hitwhwlj	1	0	0	1
hkdobrev	https://github.com/hkdobrev	1	0	0	1
hnakamur	https://github.com/hnakamur	2	0	0	2
hoeckele	https://github.com/hoeckele	1	0	0	1
hohwille	https://github.com/hohwille	1	1	0	2
hopcroft	https://github.com/hopcroft	1	0	0	1
horaceho	https://github.com/horaceho	1	0	0	1
horejsek	https://github.com/horejsek	0	6	0	6
hounsell	https://github.com/hounsell	3	0	0	3
hrydgard	https://github.com/hrydgard	0	2	0	2
htmfilho	https://github.com/htmfilho	1	1	0	2
hvelarde	https://github.com/hvelarde	3	2	0	5
iOSDevil	https://github.com/iOSDevil	2	1	0	3
iVanShub	https://github.com/iVanShub	14	0	0	14
idlesign	https://github.com/idlesign	0	1	0	1
ihnorton	https://github.com/ihnorton	0	6	0	6
impworks	https://github.com/impworks	0	1	0	1
indirect	https://github.com/indirect	0	1	0	1
indykish	https://github.com/indykish	3	0	0	3
info2000	https://github.com/info2000	1	0	0	1
iolevsky	https://github.com/iolevsky	1	0	0	1
ionutvmi	https://github.com/ionutvmi	0	1	0	1
iperdomo	https://github.com/iperdomo	1	0	0	1
iwehrman	https://github.com/iwehrman	1	0	0	1
jagtalon	https://github.com/jagtalon	0	1	0	1
jakwings	https://github.com/jakwings	1	1	0	2
jalvesaq	https://github.com/jalvesaq	0	1	0	1
jandever	https://github.com/jandever	5	1	0	6
janmeier	https://github.com/janmeier	0	1	0	1
janpecha	https://github.com/janpecha	9	0	0	9
jasarien	https://github.com/jasarien	0	1	0	1
javajolt	https://github.com/javajolt	0	1	1	2
javruben	https://github.com/javruben	1	0	0	1
jayhuber	https://github.com/jayhuber	0	1	0	1
jaypoulz	https://github.com/jaypoulz	1	0	0	1
jbarbier	https://github.com/jbarbier	3	0	0	3
jbonacci	https://github.com/jbonacci	4	1	0	5
jbruggem	https://github.com/jbruggem	2	1	0	3
jcfranco	https://github.com/jcfranco	0	1	0	1
jchubber	https://github.com/jchubber	1	0	0	1
jdegroot	https://github.com/jdegroot	1	0	0	1
jdeolive	https://github.com/jdeolive	1	1	0	2
jdoliner	https://github.com/jdoliner	1	0	0	1
jdorfman	https://github.com/jdorfman	2	1	0	3
jefflunt	https://github.com/jefflunt	1	0	0	1
jelovirt	https://github.com/jelovirt	0	1	0	1
jennydvr	https://github.com/jennydvr	0	1	0	1
jeroenvs	https://github.com/jeroenvs	2	4	0	6
jerryorr	https://github.com/jerryorr	1	0	0	1
jespersm	https://github.com/jespersm	1	0	0	1
jessevdk	https://github.com/jessevdk	0	1	0	1
jfarcand	https://github.com/jfarcand	1	8	0	9
jfarid27	https://github.com/jfarid27	1	0	0	1
jgostick	https://github.com/jgostick	2	2	0	4
jhermann	https://github.com/jhermann	0	1	0	1
jheusala	https://github.com/jheusala	1	0	0	1
jhfrench	https://github.com/jhfrench	0	1	0	1
jhudson8	https://github.com/jhudson8	1	0	0	1
jigzstar	https://github.com/jigzstar	1	0	0	1
jimi1283	https://github.com/jimi1283	0	4	0	4
jimmykuu	https://github.com/jimmykuu	0	1	0	1
jj0hns0n	https://github.com/jj0hns0n	1	4	0	5
jkingdon	https://github.com/jkingdon	1	1	0	2
jkokenge	https://github.com/jkokenge	2	0	0	2
jlmcgraw	https://github.com/jlmcgraw	1	0	0	1
jluttine	https://github.com/jluttine	0	1	0	1
jmbowman	https://github.com/jmbowman	0	0	1	1
jmervine	https://github.com/jmervine	2	3	0	5
jmhodges	https://github.com/jmhodges	2	0	0	2
jmos1277	https://github.com/jmos1277	0	1	0	1
jnaylor2	https://github.com/jnaylor2	1	0	0	1
jodytate	https://github.com/jodytate	1	0	0	1
joehoyle	https://github.com/joehoyle	2	0	0	2
joergwin	https://github.com/joergwin	1	0	0	1
joichiro	https://github.com/joichiro	15	1	0	16
jojosati	https://github.com/jojosati	0	1	0	1
jojouser	https://github.com/jojouser	1	0	0	1
jonasman	https://github.com/jonasman	1	0	0	1
jonbrett	https://github.com/jonbrett	2	0	0	2
jonnydee	https://github.com/jonnydee	2	2	0	4
jorgebay	https://github.com/jorgebay	0	1	0	1
jostster	https://github.com/jostster	0	1	0	1
jpillora	https://github.com/jpillora	0	1	0	1
jpscharf	https://github.com/jpscharf	1	0	0	1
jpstroop	https://github.com/jpstroop	1	0	0	1
jrafanie	https://github.com/jrafanie	0	1	0	1
jrudolph	https://github.com/jrudolph	1	1	0	2
jseabold	https://github.com/jseabold	2	0	0	2
jsgoupil	https://github.com/jsgoupil	1	0	0	1
jskorton	https://github.com/jskorton	1	0	0	1
jsuereth	https://github.com/jsuereth	0	1	0	1
jtRIPper	https://github.com/jtRIPper	1	0	0	1
jtratner	https://github.com/jtratner	2	1	0	3
juanmaia	https://github.com/juanmaia	1	0	0	1
juasiepo	https://github.com/juasiepo	1	0	0	1
julesies	https://github.com/julesies	1	0	0	1
june0cho	https://github.com/june0cho	1	0	0	1
justinmk	https://github.com/justinmk	2	0	0	2
juukie14	https://github.com/juukie14	0	1	0	1
juuxstar	https://github.com/juuxstar	1	0	0	1
jvcleave	https://github.com/jvcleave	0	1	0	1
jverzani	https://github.com/jverzani	1	0	0	1
jvshahid	https://github.com/jvshahid	0	1	0	1
jweslley	https://github.com/jweslley	0	1	0	1
jywarren	https://github.com/jywarren	0	2	0	2
kabexnuf	https://github.com/kabexnuf	4	0	0	4
kabhinav	https://github.com/kabhinav	0	1	0	1
katapulp	https://github.com/katapulp	1	0	0	1
kavarell	https://github.com/kavarell	1	0	0	1
kazuhisa	https://github.com/kazuhisa	1	0	0	1
kchaloux	https://github.com/kchaloux	1	0	0	1
kelbyers	https://github.com/kelbyers	1	0	0	1
kennyhei	https://github.com/kennyhei	0	1	0	1
kentliau	https://github.com/kentliau	1	0	0	1
kerchner	https://github.com/kerchner	2	0	0	2
kern3020	https://github.com/kern3020	1	1	0	2
kev40293	https://github.com/kev40293	1	0	0	1
kincajou	https://github.com/kincajou	1	0	0	1
kklipsch	https://github.com/kklipsch	1	0	0	1
kloesing	https://github.com/kloesing	1	0	0	1
kmanzana	https://github.com/kmanzana	1	0	0	1
kmmathis	https://github.com/kmmathis	1	0	0	1
koenpunt	https://github.com/koenpunt	1	0	0	1
kohltomi	https://github.com/kohltomi	1	0	0	1
kos59125	https://github.com/kos59125	2	2	0	4
kosgan10	https://github.com/kosgan10	1	0	0	1
kpdecker	https://github.com/kpdecker	1	0	0	1
kronflux	https://github.com/kronflux	1	0	0	1
krues8dr	https://github.com/krues8dr	4	0	0	4
kubark42	https://github.com/kubark42	0	1	0	1
kvasnica	https://github.com/kvasnica	1	0	0	1
larstobi	https://github.com/larstobi	1	0	0	1
laurentj	https://github.com/laurentj	0	1	0	1
lazarus9	https://github.com/lazarus9	1	0	0	1
lboynton	https://github.com/lboynton	0	1	0	1
ldardini	https://github.com/ldardini	1	0	0	1
ldhughes	https://github.com/ldhughes	1	0	0	1
lee-dohm	https://github.com/lee-dohm	1	0	0	1
leofeyer	https://github.com/leofeyer	0	3	0	3
leouieda	https://github.com/leouieda	0	2	0	2
lericson	https://github.com/lericson	0	1	0	1
leslieho	https://github.com/leslieho	1	0	0	1
lfiebach	https://github.com/lfiebach	0	1	0	1
liamdawe	https://github.com/liamdawe	0	1	0	1
lmartins	https://github.com/lmartins	1	0	0	1
logofive	https://github.com/logofive	1	0	0	1
loolooii	https://github.com/loolooii	1	0	0	1
lossyrob	https://github.com/lossyrob	0	5	0	5
lovedota	https://github.com/lovedota	1	0	0	1
loweherz	https://github.com/loweherz	1	0	0	1
lowtower	https://github.com/lowtower	1	0	0	1
lpsoltys	https://github.com/lpsoltys	3	2	0	5
lugubugu	https://github.com/lugubugu	0	1	0	1
luversof	https://github.com/luversof	1	0	0	1
m99coder	https://github.com/m99coder	2	0	0	2
macemmek	https://github.com/macemmek	1	0	0	1
macfreek	https://github.com/macfreek	0	1	0	1
macintux	https://github.com/macintux	1	0	0	1
macropin	https://github.com/macropin	1	0	0	1
macrosak	https://github.com/macrosak	1	0	0	1
madmed88	https://github.com/madmed88	2	0	0	2
madovsky	https://github.com/madovsky	1	0	0	1
madrobby	https://github.com/madrobby	1	0	0	1
mage-eag	https://github.com/mage-eag	0	1	0	1
mamont77	https://github.com/mamont77	0	1	0	1
manpages	https://github.com/manpages	2	0	0	2
manzar03	https://github.com/manzar03	1	0	0	1
marco135	https://github.com/marco135	1	0	0	1
marczych	https://github.com/marczych	1	0	0	1
mardukbp	https://github.com/mardukbp	1	0	0	1
mareuter	https://github.com/mareuter	2	2	0	4
markcowl	https://github.com/markcowl	0	1	0	1
markiewb	https://github.com/markiewb	1	2	0	3
masonmei	https://github.com/masonmei	1	0	0	1
matalina	https://github.com/matalina	2	1	0	3
mathdu07	https://github.com/mathdu07	2	0	0	2
matmoody	https://github.com/matmoody	1	1	0	2
matt-han	https://github.com/matt-han	1	0	0	1
maxchill	https://github.com/maxchill	1	0	0	1
maximebf	https://github.com/maximebf	0	1	0	1
mbostock	https://github.com/mbostock	1	1	0	2
mcaprari	https://github.com/mcaprari	0	8	0	8
mcomella	https://github.com/mcomella	1	0	0	1
mcooganj	https://github.com/mcooganj	1	0	0	1
mdippery	https://github.com/mdippery	1	0	0	1
mdumrauf	https://github.com/mdumrauf	1	0	0	1
me4oslav	https://github.com/me4oslav	1	1	0	2
mensor91	https://github.com/mensor91	3	0	0	3
meverone	https://github.com/meverone	0	2	0	2
mfellner	https://github.com/mfellner	0	1	0	1
mgaunard	https://github.com/mgaunard	2	2	0	4
mgryszko	https://github.com/mgryszko	0	1	0	1
mheffner	https://github.com/mheffner	0	1	0	1
mheilman	https://github.com/mheilman	1	1	0	2
mickours	https://github.com/mickours	1	0	0	1
mihneadb	https://github.com/mihneadb	1	0	0	1
mikerobi	https://github.com/mikerobi	1	0	0	1
mikeumus	https://github.com/mikeumus	2	0	0	2
mikila85	https://github.com/mikila85	1	0	0	1
minikomi	https://github.com/minikomi	0	4	0	4
mirguest	https://github.com/mirguest	1	0	0	1
mirubiri	https://github.com/mirubiri	1	0	0	1
mishanga	https://github.com/mishanga	0	1	0	1
mitechie	https://github.com/mitechie	1	0	0	1
mjallday	https://github.com/mjallday	1	0	0	1
mjarthur	https://github.com/mjarthur	2	0	0	2
mjgiarlo	https://github.com/mjgiarlo	1	1	0	2
mkinberg	https://github.com/mkinberg	1	0	0	1
mkobetic	https://github.com/mkobetic	1	0	0	1
mkotsbak	https://github.com/mkotsbak	1	0	0	1
mkraning	https://github.com/mkraning	1	0	0	1
mkutgt72	https://github.com/mkutgt72	1	0	0	1
mkweskin	https://github.com/mkweskin	1	0	0	1
mlf176f2	https://github.com/mlf176f2	1	0	0	1
mlippert	https://github.com/mlippert	1	0	0	1
mlusetti	https://github.com/mlusetti	1	0	0	1
mmcgahan	https://github.com/mmcgahan	0	1	0	1
mmcguinn	https://github.com/mmcguinn	0	1	0	1
mndfcked	https://github.com/mndfcked	0	1	0	1
moimikey	https://github.com/moimikey	1	0	0	1
monfresh	https://github.com/monfresh	1	0	0	1
moonglum	https://github.com/moonglum	1	0	0	1
mortenwh	https://github.com/mortenwh	1	0	0	1
mpasquin	https://github.com/mpasquin	0	1	0	1
mpdehaan	https://github.com/mpdehaan	0	4	0	4
mquinson	https://github.com/mquinson	0	1	0	1
mransley	https://github.com/mransley	1	0	0	1
mrturtle	https://github.com/mrturtle	0	1	0	1
msabramo	https://github.com/msabramo	1	0	0	1
msampaio	https://github.com/msampaio	0	1	0	1
msgameng	https://github.com/msgameng	1	0	0	1
msiebuhr	https://github.com/msiebuhr	1	1	0	2
msievers	https://github.com/msievers	2	2	0	4
msteiger	https://github.com/msteiger	0	1	0	1
mstelzer	https://github.com/mstelzer	1	0	0	1
mtbrandy	https://github.com/mtbrandy	1	0	0	1
muellert	https://github.com/muellert	0	1	0	1
murphysj	https://github.com/murphysj	0	1	0	1
mvglasow	https://github.com/mvglasow	0	3	0	3
mwaylabs	https://github.com/mwaylabs	1	0	0	1
mwbinger	https://github.com/mwbinger	1	0	0	1
mwbrooks	https://github.com/mwbrooks	0	1	0	1
mworrell	https://github.com/mworrell	1	0	0	1
myjangle	https://github.com/myjangle	1	0	0	1
naourass	https://github.com/naourass	2	0	0	2
nazar-pc	https://github.com/nazar-pc	1	0	0	1
ncalexan	https://github.com/ncalexan	2	0	0	2
neuralnw	https://github.com/neuralnw	1	1	0	2
newbcode	https://github.com/newbcode	3	1	0	4
nhandler	https://github.com/nhandler	1	1	0	2
nichtich	https://github.com/nichtich	5	0	0	5
nickclaw	https://github.com/nickclaw	1	2	0	3
nicoabie	https://github.com/nicoabie	1	0	0	1
nicosomb	https://github.com/nicosomb	3	2	0	5
nihlaeth	https://github.com/nihlaeth	0	1	0	1
nilclass	https://github.com/nilclass	2	2	1	5
nisshiee	https://github.com/nisshiee	1	0	0	1
nkindlon	https://github.com/nkindlon	0	1	0	1
nlemoine	https://github.com/nlemoine	1	0	0	1
nodeleaf	https://github.com/nodeleaf	2	0	0	2
noinnion	https://github.com/noinnion	0	6	0	6
nosefish	https://github.com/nosefish	1	1	0	2
nquinlan	https://github.com/nquinlan	2	0	0	2
nukeador	https://github.com/nukeador	1	1	0	2
nwallace	https://github.com/nwallace	1	0	0	1
o-zander	https://github.com/o-zander	1	0	0	1
obenland	https://github.com/obenland	0	1	0	1
oberdanf	https://github.com/oberdanf	1	0	0	1
occulens	https://github.com/occulens	1	0	0	1
okashino	https://github.com/okashino	1	0	0	1
olichtne	https://github.com/olichtne	0	1	0	1
ondrowan	https://github.com/ondrowan	1	0	0	1
onei0120	https://github.com/onei0120	1	0	0	1
onyxfish	https://github.com/onyxfish	8	2	0	10
oohnoitz	https://github.com/oohnoitz	0	1	0	1
oranyero	https://github.com/oranyero	0	1	0	1
orschiro	https://github.com/orschiro	1	0	0	1
oschihin	https://github.com/oschihin	1	0	0	1
ottobyte	https://github.com/ottobyte	1	0	0	1
ozk4r123	https://github.com/ozk4r123	1	0	0	1
ozzyfant	https://github.com/ozzyfant	1	1	0	2
p0bailey	https://github.com/p0bailey	1	1	0	2
padreati	https://github.com/padreati	4	0	0	4
parameme	https://github.com/parameme	2	0	0	2
paranoiq	https://github.com/paranoiq	1	0	0	1
pastewka	https://github.com/pastewka	1	0	0	1
patinusb	https://github.com/patinusb	0	1	0	1
patriick	https://github.com/patriick	0	1	0	1
pawelfus	https://github.com/pawelfus	1	0	0	1
pbrisbin	https://github.com/pbrisbin	0	1	0	1
pennersr	https://github.com/pennersr	0	3	0	3
perrygeo	https://github.com/perrygeo	1	0	0	1
petdance	https://github.com/petdance	0	1	0	1
peter099	https://github.com/peter099	1	0	0	1
peterrus	https://github.com/peterrus	1	0	0	1
philixxx	https://github.com/philixxx	1	0	0	1
pierriko	https://github.com/pierriko	1	1	0	2
pieter3d	https://github.com/pieter3d	1	0	0	1
plicease	https://github.com/plicease	5	2	0	7
pnkfelix	https://github.com/pnkfelix	4	0	0	4
poolpOrg	https://github.com/poolpOrg	0	2	0	2
prad1978	https://github.com/prad1978	1	0	0	1
pranavkm	https://github.com/pranavkm	2	0	0	2
prohaska	https://github.com/prohaska	2	0	0	2
prudhomm	https://github.com/prudhomm	1	0	0	1
prysme01	https://github.com/prysme01	1	0	0	1
pukkaone	https://github.com/pukkaone	0	1	0	1
pwilkins	https://github.com/pwilkins	1	0	0	1
pwwebdev	https://github.com/pwwebdev	1	0	0	1
qcgm1978	https://github.com/qcgm1978	1	0	0	1
qiangxue	https://github.com/qiangxue	0	3	0	3
qiuxiaoj	https://github.com/qiuxiaoj	1	0	0	1
radetsky	https://github.com/radetsky	0	0	1	1
ramnathv	https://github.com/ramnathv	1	1	0	2
randallb	https://github.com/randallb	0	1	0	1
rascheel	https://github.com/rascheel	3	1	0	4
rashagen	https://github.com/rashagen	1	2	0	3
ravindar	https://github.com/ravindar	1	0	0	1
rawright	https://github.com/rawright	0	1	0	1
razbakov	https://github.com/razbakov	1	0	0	1
rbalekai	https://github.com/rbalekai	0	1	0	1
rbran100	https://github.com/rbran100	0	1	0	1
rchadwic	https://github.com/rchadwic	1	1	0	2
rcmiller	https://github.com/rcmiller	1	0	0	1
rdickert	https://github.com/rdickert	1	0	0	1
rdlowrey	https://github.com/rdlowrey	0	5	0	5
reconbot	https://github.com/reconbot	1	0	0	1
redfox14	https://github.com/redfox14	1	0	0	1
redmunds	https://github.com/redmunds	0	1	0	1
relecand	https://github.com/relecand	2	0	0	2
renanigt	https://github.com/renanigt	1	1	0	2
rgardner	https://github.com/rgardner	4	1	0	5
rhemanth	https://github.com/rhemanth	2	0	0	2
richtera	https://github.com/richtera	0	1	1	2
rickypai	https://github.com/rickypai	1	0	0	1
rikardjo	https://github.com/rikardjo	1	0	0	1
rizsotto	https://github.com/rizsotto	0	0	1	1
rjackson	https://github.com/rjackson	0	1	0	1
rjmackay	https://github.com/rjmackay	0	1	0	1
rliupeng	https://github.com/rliupeng	1	0	0	1
rmandelb	https://github.com/rmandelb	0	1	0	1
rmangino	https://github.com/rmangino	1	0	0	1
rmcastil	https://github.com/rmcastil	0	1	0	1
rmerlino	https://github.com/rmerlino	1	0	0	1
rmflight	https://github.com/rmflight	4	1	0	5
rmjarvis	https://github.com/rmjarvis	0	4	0	4
rmylonas	https://github.com/rmylonas	1	0	0	1
rnystrom	https://github.com/rnystrom	1	1	0	2
robi-wan	https://github.com/robi-wan	1	0	0	1
robweber	https://github.com/robweber	0	1	0	1
roommini	https://github.com/roommini	1	0	0	1
rowle1tj	https://github.com/rowle1tj	0	1	0	1
roykolak	https://github.com/roykolak	0	2	0	2
roystgnr	https://github.com/roystgnr	1	0	0	1
rpylipow	https://github.com/rpylipow	4	1	0	5
rrnewton	https://github.com/rrnewton	0	1	0	1
rsanheim	https://github.com/rsanheim	146	0	0	146
rstecker	https://github.com/rstecker	2	0	0	2
rsurikov	https://github.com/rsurikov	1	2	1	4
rubydagr	https://github.com/rubydagr	0	1	0	1
rudefyet	https://github.com/rudefyet	1	0	0	1
runglado	https://github.com/runglado	0	1	0	1
rwaldron	https://github.com/rwaldron	0	1	0	1
ryanatkn	https://github.com/ryanatkn	0	2	0	2
ryans233	https://github.com/ryans233	1	0	0	1
rydurham	https://github.com/rydurham	0	1	0	1
rylimaki	https://github.com/rylimaki	0	2	0	2
s-ludwig	https://github.com/s-ludwig	0	1	0	1
sagotsky	https://github.com/sagotsky	11	0	0	11
sahithya	https://github.com/sahithya	0	1	0	1
samaaron	https://github.com/samaaron	0	2	0	2
samccone	https://github.com/samccone	2	0	0	2
samsamai	https://github.com/samsamai	1	0	0	1
samuelet	https://github.com/samuelet	1	0	0	1
santalex	https://github.com/santalex	2	0	0	2
santiago	https://github.com/santiago	0	1	0	1
sanxiago	https://github.com/sanxiago	1	0	0	1
sbadakhc	https://github.com/sbadakhc	2	1	0	3
sbillard	https://github.com/sbillard	0	1	0	1
sccherry	https://github.com/sccherry	1	6	0	7
scherolt	https://github.com/scherolt	1	0	0	1
schorsch	https://github.com/schorsch	1	0	0	1
scizzorz	https://github.com/scizzorz	1	0	0	1
scoreman	https://github.com/scoreman	3	0	0	3
scriptum	https://github.com/scriptum	1	0	0	1
sdegutis	https://github.com/sdegutis	0	4	1	5
sdeleuze	https://github.com/sdeleuze	2	0	0	2
sdruskat	https://github.com/sdruskat	1	0	0	1
seamuskc	https://github.com/seamuskc	4	2	1	7
seanlong	https://github.com/seanlong	1	0	0	1
seantimm	https://github.com/seantimm	0	2	0	2
sebbacon	https://github.com/sebbacon	9	0	0	9
seblucas	https://github.com/seblucas	1	0	0	1
seregagl	https://github.com/seregagl	2	1	0	3
sewpafly	https://github.com/sewpafly	1	0	0	1
sfackler	https://github.com/sfackler	1	0	0	1
sgillies	https://github.com/sgillies	0	2	0	2
shacharz	https://github.com/shacharz	2	0	0	2
shazahm1	https://github.com/shazahm1	1	0	0	1
shelling	https://github.com/shelling	3	2	0	5
shiffman	https://github.com/shiffman	0	1	0	1
shiftkey	https://github.com/shiftkey	1	3	0	4
shmp0722	https://github.com/shmp0722	1	0	0	1
shuoli84	https://github.com/shuoli84	1	0	0	1
shurcooL	https://github.com/shurcooL	1	0	0	1
shyndman	https://github.com/shyndman	1	0	0	1
signal11	https://github.com/signal11	0	3	0	3
sinneduy	https://github.com/sinneduy	0	1	0	1
sirthias	https://github.com/sirthias	1	2	0	3
sithhell	https://github.com/sithhell	4	2	0	6
sjackman	https://github.com/sjackman	0	1	0	1
skeelogy	https://github.com/skeelogy	1	0	0	1
skybrian	https://github.com/skybrian	2	0	0	2
smashnet	https://github.com/smashnet	1	1	0	2
smickles	https://github.com/smickles	1	0	0	1
smirarab	https://github.com/smirarab	1	1	0	2
smithsps	https://github.com/smithsps	1	1	0	2
snowball	https://github.com/snowball	1	0	0	1
snschnei	https://github.com/snschnei	8	0	0	8
solarisx	https://github.com/solarisx	1	0	0	1
solbrigm	https://github.com/solbrigm	1	1	0	2
solmsted	https://github.com/solmsted	1	0	0	1
sonata82	https://github.com/sonata82	1	0	0	1
sonney2k	https://github.com/sonney2k	1	0	0	1
speakman	https://github.com/speakman	3	0	0	3
spiderck	https://github.com/spiderck	1	0	0	1
spollack	https://github.com/spollack	1	2	0	3
sproctor	https://github.com/sproctor	1	0	0	1
sprogger	https://github.com/sprogger	1	0	0	1
spurioso	https://github.com/spurioso	11	1	0	12
squaremo	https://github.com/squaremo	1	0	0	1
sritchie	https://github.com/sritchie	1	0	0	1
ssbarnea	https://github.com/ssbarnea	0	1	0	1
sshaar08	https://github.com/sshaar08	1	0	0	1
sstativa	https://github.com/sstativa	1	0	0	1
standage	https://github.com/standage	2	2	0	4
starsnet	https://github.com/starsnet	1	0	0	1
stevengj	https://github.com/stevengj	1	2	1	4
sthirugn	https://github.com/sthirugn	2	0	0	2
stlanger	https://github.com/stlanger	1	0	0	1
stolstov	https://github.com/stolstov	0	1	0	1
stonebig	https://github.com/stonebig	1	0	0	1
stuartpb	https://github.com/stuartpb	1	0	0	1
stvnrlly	https://github.com/stvnrlly	0	1	0	1
sunalive	https://github.com/sunalive	1	0	0	1
sylvinus	https://github.com/sylvinus	1	0	0	1
szaqal83	https://github.com/szaqal83	1	0	0	1
taconaut	https://github.com/taconaut	1	0	0	1
tagliala	https://github.com/tagliala	0	2	1	3
tamorris	https://github.com/tamorris	0	1	0	1
tantaman	https://github.com/tantaman	0	1	0	1
tarcieri	https://github.com/tarcieri	2	0	0	2
tarosuke	https://github.com/tarosuke	1	0	0	1
tartalia	https://github.com/tartalia	1	0	0	1
tauberer	https://github.com/tauberer	1	0	0	1
tbarker9	https://github.com/tbarker9	2	5	0	7
tbekolay	https://github.com/tbekolay	1	5	0	6
tbleiker	https://github.com/tbleiker	2	0	0	2
tcozzens	https://github.com/tcozzens	3	0	0	3
tctimmeh	https://github.com/tctimmeh	1	1	0	2
teeohhem	https://github.com/teeohhem	1	0	0	1
temichus	https://github.com/temichus	4	5	0	9
terryyin	https://github.com/terryyin	2	1	0	3
tetrapus	https://github.com/tetrapus	1	0	0	1
tfmorris	https://github.com/tfmorris	1	0	0	1
tgeary90	https://github.com/tgeary90	1	0	0	1
thatch45	https://github.com/thatch45	0	3	0	3
theGarbs	https://github.com/theGarbs	1	0	0	1
thelucid	https://github.com/thelucid	1	1	0	2
thgreasi	https://github.com/thgreasi	1	0	0	1
thouveng	https://github.com/thouveng	1	0	0	1
tim93422	https://github.com/tim93422	0	3	0	3
timkelty	https://github.com/timkelty	1	0	0	1
timmywil	https://github.com/timmywil	0	2	0	2
timoxley	https://github.com/timoxley	1	0	0	1
tjmannos	https://github.com/tjmannos	1	0	0	1
tmorozov	https://github.com/tmorozov	1	1	0	2
tnantais	https://github.com/tnantais	0	2	0	2
tobibeer	https://github.com/tobibeer	1	0	0	1
tobyk100	https://github.com/tobyk100	1	0	0	1
tombujok	https://github.com/tombujok	1	0	0	1
tommyuw7	https://github.com/tommyuw7	2	0	0	2
toothrot	https://github.com/toothrot	1	0	0	1
toszmasz	https://github.com/toszmasz	1	0	0	1
treasonx	https://github.com/treasonx	1	0	0	1
trichter	https://github.com/trichter	1	0	0	1
truecode	https://github.com/truecode	16	0	0	16
tshaddix	https://github.com/tshaddix	0	1	0	1
tshi0912	https://github.com/tshi0912	1	0	0	1
tsmars15	https://github.com/tsmars15	1	2	0	3
tunniclm	https://github.com/tunniclm	1	0	0	1
tw1nh3ad	https://github.com/tw1nh3ad	1	0	0	1
twmobius	https://github.com/twmobius	1	0	0	1
uniqname	https://github.com/uniqname	1	0	0	1
unity-jp	https://github.com/unity-jp	12	0	0	12
uricohen	https://github.com/uricohen	1	0	0	1
uvNikita	https://github.com/uvNikita	1	1	0	2
v-pravin	https://github.com/v-pravin	1	0	0	1
vaadbait	https://github.com/vaadbait	1	0	0	1
vastness	https://github.com/vastness	0	1	0	1
vc123456	https://github.com/vc123456	1	0	0	1
veesahni	https://github.com/veesahni	1	0	0	1
viperneo	https://github.com/viperneo	0	1	0	1
vireshas	https://github.com/vireshas	4	7	0	11
vitaliyp	https://github.com/vitaliyp	1	0	0	1
vitamino	https://github.com/vitamino	1	0	0	1
voidberg	https://github.com/voidberg	1	1	0	2
volpe28v	https://github.com/volpe28v	2	1	0	3
vrabcaku	https://github.com/vrabcaku	2	0	0	2
vtolstov	https://github.com/vtolstov	2	3	0	5
waghanza	https://github.com/waghanza	1	0	0	1
wallgeek	https://github.com/wallgeek	1	0	0	1
walterst	https://github.com/walterst	1	0	0	1
wang-bin	https://github.com/wang-bin	0	1	0	1
warpling	https://github.com/warpling	1	0	0	1
wbc-mike	https://github.com/wbc-mike	2	1	0	3
wbcchsyn	https://github.com/wbcchsyn	1	0	0	1
wearhere	https://github.com/wearhere	2	0	0	2
weitzman	https://github.com/weitzman	1	0	0	1
wenwuliu	https://github.com/wenwuliu	1	1	0	2
what4893	https://github.com/what4893	1	0	0	1
winhamwr	https://github.com/winhamwr	0	1	0	1
winsonwq	https://github.com/winsonwq	0	1	0	1
woainvzu	https://github.com/woainvzu	1	0	0	1
wolfcore	https://github.com/wolfcore	1	0	0	1
wolftune	https://github.com/wolftune	2	1	0	3
wujastyk	https://github.com/wujastyk	2	0	0	2
xaionaro	https://github.com/xaionaro	6	4	0	10
xavivars	https://github.com/xavivars	1	0	0	1
xgouchet	https://github.com/xgouchet	1	0	0	1
xieyajie	https://github.com/xieyajie	3	7	0	10
xray7224	https://github.com/xray7224	1	0	0	1
xupyprmv	https://github.com/xupyprmv	0	1	0	1
xuyq1112	https://github.com/xuyq1112	1	0	0	1
yairogen	https://github.com/yairogen	0	1	0	1
yegor256	https://github.com/yegor256	7	2	0	9
yesnault	https://github.com/yesnault	0	2	0	2
yeyong14	https://github.com/yeyong14	1	0	0	1
yiminghe	https://github.com/yiminghe	1	0	0	1
ylecuyer	https://github.com/ylecuyer	2	0	0	2
youngrok	https://github.com/youngrok	2	0	0	2
yriveiro	https://github.com/yriveiro	1	0	0	1
ytnobody	https://github.com/ytnobody	0	1	0	1
yuki1090	https://github.com/yuki1090	2	1	0	3
yulrizka	https://github.com/yulrizka	1	1	0	2
yuyichao	https://github.com/yuyichao	0	1	0	1
yvesjans	https://github.com/yvesjans	1	0	0	1
zabbarob	https://github.com/zabbarob	1	0	0	1
zanjibar	https://github.com/zanjibar	0	1	1	2
zefhemel	https://github.com/zefhemel	0	2	0	2
zer0her0	https://github.com/zer0her0	1	0	0	1
zhuochun	https://github.com/zhuochun	3	3	0	6
zhuzhuor	https://github.com/zhuzhuor	1	0	0	1
zmiceruk	https://github.com/zmiceruk	1	0	0	1
zspencer	https://github.com/zspencer	0	3	0	3
128keaton	https://github.com/128keaton	2	0	0	2
240638006	https://github.com/240638006	1	0	0	1
853486395	https://github.com/853486395	1	0	0	1
ANiknejad	https://github.com/ANiknejad	1	0	0	1
Aethylred	https://github.com/Aethylred	1	0	0	1
AgelxNash	https://github.com/AgelxNash	5	5	0	10
Alcanmage	https://github.com/Alcanmage	0	2	0	2
AlisonTRF	https://github.com/AlisonTRF	1	0	0	1
AlloVince	https://github.com/AlloVince	1	0	0	1
Auersberg	https://github.com/Auersberg	0	1	0	1
Badumsaen	https://github.com/Badumsaen	1	0	0	1
Baltazore	https://github.com/Baltazore	1	0	0	1
Barmunksu	https://github.com/Barmunksu	1	0	0	1
BeIZebuth	https://github.com/BeIZebuth	1	1	0	2
Betaman2k	https://github.com/Betaman2k	1	0	0	1
Blackmist	https://github.com/Blackmist	3	0	0	3
Blackmoor	https://github.com/Blackmoor	1	0	0	1
Catanzaro	https://github.com/Catanzaro	2	0	0	2
Catscrash	https://github.com/Catscrash	1	0	0	1
ChrisWren	https://github.com/ChrisWren	5	0	0	5
Chrysweel	https://github.com/Chrysweel	1	0	0	1
Cysioland	https://github.com/Cysioland	1	0	0	1
DHolloran	https://github.com/DHolloran	0	1	0	1
DMcCunney	https://github.com/DMcCunney	2	0	0	2
DeRomanok	https://github.com/DeRomanok	1	0	0	1
DennisVis	https://github.com/DennisVis	2	0	0	2
DingoSEAD	https://github.com/DingoSEAD	2	0	0	2
Downchuck	https://github.com/Downchuck	1	0	0	1
DylanShea	https://github.com/DylanShea	1	0	0	1
EHLOVader	https://github.com/EHLOVader	2	0	0	2
EJBMartyr	https://github.com/EJBMartyr	1	0	0	1
ENGINETEC	https://github.com/ENGINETEC	1	1	0	2
Edwardzyc	https://github.com/Edwardzyc	1	0	0	1
ElwingGit	https://github.com/ElwingGit	0	1	0	1
Eric89GXL	https://github.com/Eric89GXL	1	0	0	1
Espiandev	https://github.com/Espiandev	0	1	0	1
Estupendo	https://github.com/Estupendo	1	0	0	1
FGRibreau	https://github.com/FGRibreau	1	0	0	1
FTWinston	https://github.com/FTWinston	1	1	0	2
Fattydorf	https://github.com/Fattydorf	0	2	0	2
FiG-Scorn	https://github.com/FiG-Scorn	1	0	0	1
FluxCraft	https://github.com/FluxCraft	1	0	0	1
Forceflow	https://github.com/Forceflow	0	1	0	1
Garonenur	https://github.com/Garonenur	0	1	0	1
GaryJones	https://github.com/GaryJones	1	1	0	2
Gerifield	https://github.com/Gerifield	1	0	0	1
Gimperion	https://github.com/Gimperion	1	2	0	3
Glavin001	https://github.com/Glavin001	8	5	1	14
GraphiXS6	https://github.com/GraphiXS6	1	0	0	1
Haehnchen	https://github.com/Haehnchen	1	3	0	4
Impact123	https://github.com/Impact123	0	2	0	2
Inaimathi	https://github.com/Inaimathi	6	3	0	9
Incognito	https://github.com/Incognito	1	0	0	1
JPGygax68	https://github.com/JPGygax68	1	0	0	1
JedWatson	https://github.com/JedWatson	1	4	0	5
Jerry77oz	https://github.com/Jerry77oz	0	1	0	1
Jienvaldo	https://github.com/Jienvaldo	1	0	0	1
JinpengLI	https://github.com/JinpengLI	1	0	0	1
JohnReppy	https://github.com/JohnReppy	1	0	0	1
JoshClose	https://github.com/JoshClose	0	1	0	1
JostBaron	https://github.com/JostBaron	0	1	0	1
Kambfhase	https://github.com/Kambfhase	0	1	0	1
KariTrace	https://github.com/KariTrace	1	0	0	1
Kro55f1r3	https://github.com/Kro55f1r3	1	0	0	1
LeBlaaanc	https://github.com/LeBlaaanc	7	7	0	14
Lineflyer	https://github.com/Lineflyer	1	0	0	1
LinguList	https://github.com/LinguList	1	0	0	1
Lithumist	https://github.com/Lithumist	2	0	0	2
LordVeral	https://github.com/LordVeral	1	0	0	1
Maethorin	https://github.com/Maethorin	1	1	0	2
Margarine	https://github.com/Margarine	1	1	0	2
MasDennis	https://github.com/MasDennis	0	1	0	1
Matheus28	https://github.com/Matheus28	1	0	0	1
MaxUlysse	https://github.com/MaxUlysse	2	0	0	2
MaxWagner	https://github.com/MaxWagner	2	0	0	2
MikeSalyh	https://github.com/MikeSalyh	1	0	0	1
Mini-Geek	https://github.com/Mini-Geek	2	2	0	4
NecroKote	https://github.com/NecroKote	1	0	0	1
NickClark	https://github.com/NickClark	1	0	0	1
Nicolas-L	https://github.com/Nicolas-L	0	5	0	5
NikhilS91	https://github.com/NikhilS91	1	0	0	1
NikolayIT	https://github.com/NikolayIT	1	0	0	1
OmegaPhil	https://github.com/OmegaPhil	1	0	0	1
Pallinder	https://github.com/Pallinder	2	0	0	2
Pneumatus	https://github.com/Pneumatus	1	0	0	1
Presssack	https://github.com/Presssack	1	0	0	1
PsychoSid	https://github.com/PsychoSid	0	1	0	1
RamRaider	https://github.com/RamRaider	1	0	0	1
RaymiiOrg	https://github.com/RaymiiOrg	1	0	0	1
RedXephos	https://github.com/RedXephos	1	0	0	1
RobeeeJay	https://github.com/RobeeeJay	1	0	0	1
RoyTheB0y	https://github.com/RoyTheB0y	1	0	0	1
SamWhited	https://github.com/SamWhited	8	2	0	10
Scarygami	https://github.com/Scarygami	0	2	0	2
Sdogruyol	https://github.com/Sdogruyol	1	0	0	1
Sebmaster	https://github.com/Sebmaster	0	1	0	1
Skylark14	https://github.com/Skylark14	2	0	0	2
SomaticIT	https://github.com/SomaticIT	0	1	0	1
Studio384	https://github.com/Studio384	3	3	0	6
SudeshnaB	https://github.com/SudeshnaB	2	1	0	3
Sunstrike	https://github.com/Sunstrike	0	1	0	1
T3am5hark	https://github.com/T3am5hark	0	1	0	1
TApicella	https://github.com/TApicella	1	1	0	2
Tetsumaki	https://github.com/Tetsumaki	2	0	0	2
Texicitys	https://github.com/Texicitys	1	0	0	1
Tiger0915	https://github.com/Tiger0915	1	0	0	1
TonyAbell	https://github.com/TonyAbell	1	0	0	1
TopherMan	https://github.com/TopherMan	1	0	0	1
Tysonzero	https://github.com/Tysonzero	1	0	0	1
VWoeltjen	https://github.com/VWoeltjen	2	0	0	2
WanWizard	https://github.com/WanWizard	0	1	0	1
Wildhoney	https://github.com/Wildhoney	0	1	0	1
XavierVal	https://github.com/XavierVal	1	0	0	1
aalvarado	https://github.com/aalvarado	1	0	0	1
aamir2007	https://github.com/aamir2007	1	0	0	1
aarellano	https://github.com/aarellano	0	11	0	11
aaronburr	https://github.com/aaronburr	1	0	0	1
aashish24	https://github.com/aashish24	0	3	0	3
abcfree01	https://github.com/abcfree01	1	0	0	1
abierbaum	https://github.com/abierbaum	6	10	7	23
acacheung	https://github.com/acacheung	0	7	0	7
achaparro	https://github.com/achaparro	1	0	0	1
acidprime	https://github.com/acidprime	0	1	0	1
actboy168	https://github.com/actboy168	0	1	0	1
adamfeuer	https://github.com/adamfeuer	0	1	0	1
adammeyer	https://github.com/adammeyer	2	0	0	2
adamnagel	https://github.com/adamnagel	1	0	0	1
adegroote	https://github.com/adegroote	0	1	0	1
adiherzog	https://github.com/adiherzog	1	0	0	1
after12am	https://github.com/after12am	1	1	0	2
agbeltran	https://github.com/agbeltran	1	0	0	1
agentlame	https://github.com/agentlame	1	0	0	1
agmartins	https://github.com/agmartins	1	0	0	1
agueganno	https://github.com/agueganno	0	1	0	1
aheckmann	https://github.com/aheckmann	0	2	0	2
airbone42	https://github.com/airbone42	1	0	0	1
airportyh	https://github.com/airportyh	0	3	0	3
ajcummins	https://github.com/ajcummins	12	1	0	13
ajjimenez	https://github.com/ajjimenez	1	1	0	2
akdetrick	https://github.com/akdetrick	2	0	0	2
alan-reed	https://github.com/alan-reed	1	0	0	1
alex05615	https://github.com/alex05615	1	0	0	1
alexandrz	https://github.com/alexandrz	1	0	0	1
alexburke	https://github.com/alexburke	1	0	0	1
alexdowad	https://github.com/alexdowad	1	1	0	2
alexlomax	https://github.com/alexlomax	2	2	0	4
alexsilva	https://github.com/alexsilva	1	0	0	1
alimoeeny	https://github.com/alimoeeny	0	3	0	3
alisajedi	https://github.com/alisajedi	1	0	0	1
alnewkirk	https://github.com/alnewkirk	0	2	0	2
alterm4nn	https://github.com/alterm4nn	0	3	0	3
alucard62	https://github.com/alucard62	0	1	0	1
amado4884	https://github.com/amado4884	2	0	0	2
amirouche	https://github.com/amirouche	1	0	0	1
ananelson	https://github.com/ananelson	3	3	0	6
anchan828	https://github.com/anchan828	0	989	0	989
andreacfm	https://github.com/andreacfm	1	0	0	1
andreasvc	https://github.com/andreasvc	0	1	0	1
andrejoe7	https://github.com/andrejoe7	1	0	0	1
andrewcam	https://github.com/andrewcam	1	0	0	1
andromaex	https://github.com/andromaex	1	0	0	1
andychups	https://github.com/andychups	1	0	0	1
andyjagoe	https://github.com/andyjagoe	1	0	0	1
andyswift	https://github.com/andyswift	8	3	0	11
anirudhSK	https://github.com/anirudhSK	1	0	0	1
apolloeye	https://github.com/apolloeye	1	0	0	1
aprescott	https://github.com/aprescott	2	0	0	2
arnuschky	https://github.com/arnuschky	1	0	0	1
arthurj58	https://github.com/arthurj58	4	0	0	4
atif-frag	https://github.com/atif-frag	1	0	0	1
avnazarov	https://github.com/avnazarov	3	0	0	3
barankhan	https://github.com/barankhan	1	0	0	1
bayram4ik	https://github.com/bayram4ik	1	0	0	1
bazilio91	https://github.com/bazilio91	11	1	0	12
bcjwilson	https://github.com/bcjwilson	1	0	0	1
bencallis	https://github.com/bencallis	1	0	0	1
bendalton	https://github.com/bendalton	2	0	0	2
benfoxall	https://github.com/benfoxall	1	0	0	1
benjholla	https://github.com/benjholla	0	1	0	1
benmathes	https://github.com/benmathes	1	0	0	1
berlintam	https://github.com/berlintam	0	1	0	1
bfosberry	https://github.com/bfosberry	1	1	0	2
billychan	https://github.com/billychan	1	0	0	1
binarymax	https://github.com/binarymax	1	0	0	1
bing-deng	https://github.com/bing-deng	5	2	0	7
bitemyapp	https://github.com/bitemyapp	0	1	0	1
bke-drewb	https://github.com/bke-drewb	1	0	0	1
blackfist	https://github.com/blackfist	0	2	0	2
blackfyre	https://github.com/blackfyre	2	1	0	3
bnadlerjr	https://github.com/bnadlerjr	1	0	0	1
boboroshi	https://github.com/boboroshi	0	1	0	1
bpadalino	https://github.com/bpadalino	4	0	0	4
bradparks	https://github.com/bradparks	0	1	0	1
brandc747	https://github.com/brandc747	2	0	0	2
brasofilo	https://github.com/brasofilo	0	1	0	1
brigadier	https://github.com/brigadier	1	0	0	1
brookevmf	https://github.com/brookevmf	1	0	0	1
brunobord	https://github.com/brunobord	1	0	0	1
bryanboza	https://github.com/bryanboza	1	0	0	1
bsiddiqui	https://github.com/bsiddiqui	1	0	0	1
bsvensson	https://github.com/bsvensson	2	0	0	2
byteGator	https://github.com/byteGator	2	0	0	2
c-schmitt	https://github.com/c-schmitt	1	0	0	1
cacuestai	https://github.com/cacuestai	1	0	0	1
ccandreva	https://github.com/ccandreva	1	0	0	1
cellulosa	https://github.com/cellulosa	1	0	0	1
censink14	https://github.com/censink14	1	1	0	2
cgcostume	https://github.com/cgcostume	1	0	0	1
cgendreau	https://github.com/cgendreau	1	0	0	1
charettes	https://github.com/charettes	0	2	1	3
charlieok	https://github.com/charlieok	1	0	0	1
chcholman	https://github.com/chcholman	1	0	0	1
cheesenoc	https://github.com/cheesenoc	0	1	0	1
chipbell4	https://github.com/chipbell4	2	0	0	2
ciubotaru	https://github.com/ciubotaru	0	1	0	1
cjansen18	https://github.com/cjansen18	1	0	0	1
ckhroulev	https://github.com/ckhroulev	0	3	0	3
clang-omp	https://github.com/clang-omp	0	1	0	1
clark1201	https://github.com/clark1201	5	1	0	6
claytical	https://github.com/claytical	0	2	0	2
clienthax	https://github.com/clienthax	1	0	0	1
clone1018	https://github.com/clone1018	0	1	0	1
cmbennett	https://github.com/cmbennett	3	0	0	3
cobuChris	https://github.com/cobuChris	4	3	0	7
codylerum	https://github.com/codylerum	2	1	0	3
colszowka	https://github.com/colszowka	0	1	0	1
compost0x	https://github.com/compost0x	1	0	0	1
cpsubrian	https://github.com/cpsubrian	1	1	0	2
cptcotton	https://github.com/cptcotton	1	0	0	1
crdeutsch	https://github.com/crdeutsch	1	0	0	1
creighton	https://github.com/creighton	0	1	0	1
crynobone	https://github.com/crynobone	2	2	0	4
csobrinho	https://github.com/csobrinho	1	0	0	1
cullenenn	https://github.com/cullenenn	1	0	0	1
dabelknap	https://github.com/dabelknap	0	1	0	1
dachshund	https://github.com/dachshund	0	3	0	3
daegon123	https://github.com/daegon123	1	0	0	1
danandrei	https://github.com/danandrei	0	1	0	1
dancabral	https://github.com/dancabral	3	1	0	4
danielkzu	https://github.com/danielkzu	0	24	0	24
danipilze	https://github.com/danipilze	1	0	0	1
dannyedel	https://github.com/dannyedel	0	1	0	1
darshanrp	https://github.com/darshanrp	1	1	0	2
dasmurphy	https://github.com/dasmurphy	0	1	0	1
davboecki	https://github.com/davboecki	0	2	0	2
davesouth	https://github.com/davesouth	0	1	0	1
davidebbo	https://github.com/davidebbo	1	1	0	2
davidyell	https://github.com/davidyell	0	1	0	1
davisford	https://github.com/davisford	0	1	0	1
davisoski	https://github.com/davisoski	1	0	0	1
dayletter	https://github.com/dayletter	1	0	0	1
dbashford	https://github.com/dbashford	1	3	0	4
ddelmonte	https://github.com/ddelmonte	1	0	0	1
delasteve	https://github.com/delasteve	6	1	0	7
deltakosh	https://github.com/deltakosh	0	1	0	1
derdesign	https://github.com/derdesign	1	0	0	1
derekeder	https://github.com/derekeder	0	1	0	1
design365	https://github.com/design365	1	0	0	1
devlights	https://github.com/devlights	0	1	0	1
devnewton	https://github.com/devnewton	1	0	0	1
dexterliu	https://github.com/dexterliu	0	1	0	1
dhylender	https://github.com/dhylender	0	4	0	4
didory123	https://github.com/didory123	0	1	0	1
djangofan	https://github.com/djangofan	2	0	0	2
dlcarmean	https://github.com/dlcarmean	1	0	0	1
dlidstrom	https://github.com/dlidstrom	1	0	0	1
dmcall774	https://github.com/dmcall774	6	1	0	7
dmikalova	https://github.com/dmikalova	1	0	0	1
dmopalmer	https://github.com/dmopalmer	0	1	0	1
dockimbel	https://github.com/dockimbel	0	1	0	1
donkarlos	https://github.com/donkarlos	4	0	0	4
donmerlin	https://github.com/donmerlin	1	0	0	1
dreamfall	https://github.com/dreamfall	1	0	0	1
drrcknlsn	https://github.com/drrcknlsn	1	0	0	1
dsalychev	https://github.com/dsalychev	1	0	0	1
dshoreman	https://github.com/dshoreman	3	0	0	3
duantihua	https://github.com/duantihua	1	5	0	6
dukejones	https://github.com/dukejones	1	0	0	1
eastridge	https://github.com/eastridge	2	0	0	2
eclifford	https://github.com/eclifford	1	0	0	1
eddiewebb	https://github.com/eddiewebb	2	0	0	2
edward123	https://github.com/edward123	0	2	0	2
egfconnor	https://github.com/egfconnor	1	0	0	1
ehaspulat	https://github.com/ehaspulat	0	2	0	2
eighthave	https://github.com/eighthave	0	3	0	3
elifarley	https://github.com/elifarley	1	0	0	1
elizahyde	https://github.com/elizahyde	3	0	0	3
erbriones	https://github.com/erbriones	1	0	0	1
erurainon	https://github.com/erurainon	1	0	0	1
ervwalter	https://github.com/ervwalter	1	0	0	1
eslab2013	https://github.com/eslab2013	1	0	0	1
estivalet	https://github.com/estivalet	1	1	0	2
eversteeg	https://github.com/eversteeg	1	0	0	1
eviltrout	https://github.com/eviltrout	1	0	0	1
eyeeyeeye	https://github.com/eyeeyeeye	1	0	0	1
ezequielm	https://github.com/ezequielm	0	1	0	1
felicitus	https://github.com/felicitus	0	10	0	10
ferfebles	https://github.com/ferfebles	1	0	0	1
feuerbach	https://github.com/feuerbach	1	0	0	1
fgrosswig	https://github.com/fgrosswig	0	1	0	1
filipebfs	https://github.com/filipebfs	1	0	0	1
flamsmark	https://github.com/flamsmark	0	1	0	1
floroxmar	https://github.com/floroxmar	1	1	0	2
foxmclaud	https://github.com/foxmclaud	1	0	0	1
frankiefu	https://github.com/frankiefu	1	2	1	4
fred-wang	https://github.com/fred-wang	2	0	0	2
freeplant	https://github.com/freeplant	0	1	0	1
fuerchter	https://github.com/fuerchter	3	3	0	6
fumitoito	https://github.com/fumitoito	0	1	0	1
fwilson42	https://github.com/fwilson42	0	1	0	1
gabehayes	https://github.com/gabehayes	1	0	0	1
garcia-jj	https://github.com/garcia-jj	0	1	0	1
gashcrumb	https://github.com/gashcrumb	0	3	0	3
gavinking	https://github.com/gavinking	5	3	0	8
gbassiere	https://github.com/gbassiere	0	2	0	2
gbmhunter	https://github.com/gbmhunter	4	1	0	5
gdbassett	https://github.com/gdbassett	2	0	0	2
gene1wood	https://github.com/gene1wood	2	0	0	2
geoffreak	https://github.com/geoffreak	1	0	0	1
geoidesic	https://github.com/geoidesic	1	0	0	1
georgiosd	https://github.com/georgiosd	1	1	0	2
gigablast	https://github.com/gigablast	0	1	0	1
gl1000007	https://github.com/gl1000007	5	3	0	8
glantucan	https://github.com/glantucan	1	0	0	1
gmansilla	https://github.com/gmansilla	0	1	0	1
gmcferrin	https://github.com/gmcferrin	0	1	0	1
gmcgibbon	https://github.com/gmcgibbon	0	1	0	1
gneatgeek	https://github.com/gneatgeek	5	0	0	5
godgunman	https://github.com/godgunman	0	6	0	6
gottfrois	https://github.com/gottfrois	2	0	0	2
gregmarra	https://github.com/gregmarra	0	1	0	1
gregmoser	https://github.com/gregmoser	0	1	0	1
grytsenko	https://github.com/grytsenko	1	0	0	1
guofengzh	https://github.com/guofengzh	1	0	0	1
gvilarino	https://github.com/gvilarino	4	0	0	4
hackerone	https://github.com/hackerone	0	1	0	1
hadrien60	https://github.com/hadrien60	0	1	0	1
hajovonta	https://github.com/hajovonta	1	0	0	1
hallgrims	https://github.com/hallgrims	2	0	0	2
happyworm	https://github.com/happyworm	5	0	0	5
harrychan	https://github.com/harrychan	1	0	0	1
hegemonic	https://github.com/hegemonic	0	2	0	2
heidi-ann	https://github.com/heidi-ann	1	1	0	2
helios-ag	https://github.com/helios-ag	0	1	0	1
himanshu0	https://github.com/himanshu0	1	0	0	1
hinalshah	https://github.com/hinalshah	1	1	0	2
hiribarne	https://github.com/hiribarne	1	0	0	1
hodgestar	https://github.com/hodgestar	2	0	0	2
hohonuuli	https://github.com/hohonuuli	0	1	0	1
horsburgh	https://github.com/horsburgh	0	1	1	2
hunterman	https://github.com/hunterman	1	0	0	1
hxshandle	https://github.com/hxshandle	1	0	0	1
iamnessy2	https://github.com/iamnessy2	1	0	0	1
ianbarber	https://github.com/ianbarber	0	1	0	1
iangilman	https://github.com/iangilman	0	1	0	1
iantearle	https://github.com/iantearle	1	0	0	1
ianweller	https://github.com/ianweller	0	2	0	2
ibrahimyu	https://github.com/ibrahimyu	1	0	0	1
ifandelse	https://github.com/ifandelse	0	1	0	1
ifesdjeen	https://github.com/ifesdjeen	1	0	0	1
igrigorik	https://github.com/igrigorik	0	1	0	1
indexzero	https://github.com/indexzero	1	0	0	1
indraneil	https://github.com/indraneil	1	0	0	1
inflector	https://github.com/inflector	0	3	0	3
interfect	https://github.com/interfect	1	0	0	1
ionofzion	https://github.com/ionofzion	1	0	0	1
irrationl	https://github.com/irrationl	1	0	0	1
isagalaev	https://github.com/isagalaev	0	1	0	1
ivaynberg	https://github.com/ivaynberg	0	4	0	4
jackcaicn	https://github.com/jackcaicn	1	0	0	1
jacobbubu	https://github.com/jacobbubu	1	0	0	1
jacobbuck	https://github.com/jacobbuck	1	0	0	1
jairajs89	https://github.com/jairajs89	0	1	0	1
jairojair	https://github.com/jairojair	1	0	0	1
jalegre40	https://github.com/jalegre40	2	2	0	4
jamesread	https://github.com/jamesread	5	4	0	9
jamesturk	https://github.com/jamesturk	0	1	0	1
jamilatta	https://github.com/jamilatta	7	1	0	8
jamioflan	https://github.com/jamioflan	0	4	0	4
janukevic	https://github.com/janukevic	2	0	0	2
jaredbeck	https://github.com/jaredbeck	1	0	0	1
jasoncwik	https://github.com/jasoncwik	1	0	0	1
jayjacobs	https://github.com/jayjacobs	0	9	0	9
jaylinski	https://github.com/jaylinski	1	0	0	1
jaysalvat	https://github.com/jaysalvat	0	1	0	1
jbcpollak	https://github.com/jbcpollak	1	0	0	1
jcockhren	https://github.com/jcockhren	1	0	0	1
jecollins	https://github.com/jecollins	0	1	1	2
jedipunkz	https://github.com/jedipunkz	0	1	0	1
jgallen23	https://github.com/jgallen23	2	1	0	3
jgpallero	https://github.com/jgpallero	1	0	0	1
jimoleary	https://github.com/jimoleary	2	0	0	2
jimyhuang	https://github.com/jimyhuang	1	0	0	1
jinbinguo	https://github.com/jinbinguo	1	0	0	1
jlongster	https://github.com/jlongster	0	1	0	1
jloosfelt	https://github.com/jloosfelt	1	0	0	1
jlouisbiz	https://github.com/jlouisbiz	1	0	0	1
jmchilton	https://github.com/jmchilton	1	0	0	1
jmettraux	https://github.com/jmettraux	0	2	0	2
jnordberg	https://github.com/jnordberg	0	2	0	2
joaomilho	https://github.com/joaomilho	2	0	0	2
joelanman	https://github.com/joelanman	1	0	0	1
joernhees	https://github.com/joernhees	1	0	0	1
johnament	https://github.com/johnament	3	1	0	4
johny1610	https://github.com/johny1610	1	0	0	1
jonas2790	https://github.com/jonas2790	0	1	0	1
jonatkins	https://github.com/jonatkins	0	1	0	1
jonlemmon	https://github.com/jonlemmon	0	2	0	2
jorilallo	https://github.com/jorilallo	1	0	0	1
josdejong	https://github.com/josdejong	0	1	0	1
josef-pkt	https://github.com/josef-pkt	2	1	0	3
josefnpat	https://github.com/josefnpat	2	2	1	5
josevalim	https://github.com/josevalim	0	3	0	3
joshmarom	https://github.com/joshmarom	1	0	0	1
jpdeplaix	https://github.com/jpdeplaix	1	1	0	2
jperfetto	https://github.com/jperfetto	1	0	0	1
jrhorn424	https://github.com/jrhorn424	2	0	0	2
jrochkind	https://github.com/jrochkind	0	1	0	1
jrrideout	https://github.com/jrrideout	0	3	0	3
jscarrott	https://github.com/jscarrott	1	0	0	1
jstolarek	https://github.com/jstolarek	8	3	0	11
jstrachan	https://github.com/jstrachan	5	3	0	8
jtakayama	https://github.com/jtakayama	1	0	0	1
jtillmann	https://github.com/jtillmann	0	1	0	1
juanca202	https://github.com/juanca202	1	0	0	1
justinvdm	https://github.com/justinvdm	5	0	0	5
jztech101	https://github.com/jztech101	1	0	0	1
kaelzhang	https://github.com/kaelzhang	1	1	0	2
kagemusha	https://github.com/kagemusha	0	1	0	1
kageurufu	https://github.com/kageurufu	1	0	0	1
kaihendry	https://github.com/kaihendry	1	1	0	2
karbarcca	https://github.com/karbarcca	0	1	0	1
karussell	https://github.com/karussell	0	1	1	2
kawoukaka	https://github.com/kawoukaka	1	0	0	1
kazuhisya	https://github.com/kazuhisya	1	0	0	1
kblaschke	https://github.com/kblaschke	1	0	0	1
kctong529	https://github.com/kctong529	1	0	0	1
keenhenry	https://github.com/keenhenry	3	0	0	3
kevinfish	https://github.com/kevinfish	2	0	0	2
keybounce	https://github.com/keybounce	1	0	0	1
killercup	https://github.com/killercup	1	0	0	1
kirkshoop	https://github.com/kirkshoop	0	2	0	2
krisleech	https://github.com/krisleech	3	2	0	5
kwgoodman	https://github.com/kwgoodman	1	1	1	3
lafar6502	https://github.com/lafar6502	1	0	0	1
langacker	https://github.com/langacker	1	0	0	1
layerssss	https://github.com/layerssss	3	0	0	3
leistikow	https://github.com/leistikow	0	1	0	1
lemonskip	https://github.com/lemonskip	1	0	0	1
leplatrem	https://github.com/leplatrem	3	0	0	3
lexusshan	https://github.com/lexusshan	1	1	0	2
lfalvarez	https://github.com/lfalvarez	6	0	0	6
lfloresca	https://github.com/lfloresca	1	0	0	1
ljwsummer	https://github.com/ljwsummer	1	0	0	1
lloyd-uws	https://github.com/lloyd-uws	0	6	0	6
locketine	https://github.com/locketine	1	0	0	1
longstone	https://github.com/longstone	1	1	0	2
lordnynex	https://github.com/lordnynex	1	0	0	1
love12333	https://github.com/love12333	1	1	0	2
loveshell	https://github.com/loveshell	1	0	0	1
luckyyang	https://github.com/luckyyang	1	0	0	1
lukaseder	https://github.com/lukaseder	6	4	0	10
lukeapage	https://github.com/lukeapage	0	1	0	1
lullujune	https://github.com/lullujune	1	0	0	1
maani2007	https://github.com/maani2007	1	0	0	1
macarthor	https://github.com/macarthor	1	0	0	1
maditnerd	https://github.com/maditnerd	1	2	0	3
madmaxoft	https://github.com/madmaxoft	1	1	0	2
makeclean	https://github.com/makeclean	5	1	0	6
malaterre	https://github.com/malaterre	2	0	0	2
malexmave	https://github.com/malexmave	0	1	0	1
malyavkin	https://github.com/malyavkin	1	0	0	1
mangelsnc	https://github.com/mangelsnc	1	0	0	1
marksteve	https://github.com/marksteve	0	0	1	1
markstory	https://github.com/markstory	0	1	0	1
martijnvg	https://github.com/martijnvg	1	0	0	1
mattbanks	https://github.com/mattbanks	1	0	0	1
mattdrees	https://github.com/mattdrees	1	0	0	1
mattjared	https://github.com/mattjared	0	1	0	1
mattyhall	https://github.com/mattyhall	1	0	0	1
maxcnunes	https://github.com/maxcnunes	0	1	0	1
mbartos89	https://github.com/mbartos89	1	0	0	1
mbrevoort	https://github.com/mbrevoort	1	1	0	2
mccabe615	https://github.com/mccabe615	1	0	0	1
mcdull525	https://github.com/mcdull525	2	0	0	2
mcoughlin	https://github.com/mcoughlin	3	0	0	3
mhaberler	https://github.com/mhaberler	1	0	0	1
michael-e	https://github.com/michael-e	1	0	0	1
mickmuzac	https://github.com/mickmuzac	0	0	1	1
miguelpdl	https://github.com/miguelpdl	1	0	0	1
mikeboers	https://github.com/mikeboers	0	6	1	7
mikedm139	https://github.com/mikedm139	1	0	0	1
mikejiang	https://github.com/mikejiang	1	2	0	3
miketaylr	https://github.com/miketaylr	1	0	0	1
minakitty	https://github.com/minakitty	3	1	0	4
ministoat	https://github.com/ministoat	0	1	0	1
mipearson	https://github.com/mipearson	0	1	0	1
mitchellh	https://github.com/mitchellh	0	3	0	3
mkhan3189	https://github.com/mkhan3189	0	4	0	4
mkristian	https://github.com/mkristian	0	1	0	1
mlandauer	https://github.com/mlandauer	6	0	0	6
mmwoodman	https://github.com/mmwoodman	1	0	0	1
mogadanez	https://github.com/mogadanez	1	0	0	1
monkstone	https://github.com/monkstone	0	6	0	6
mouneyrac	https://github.com/mouneyrac	2	5	0	7
mousebird	https://github.com/mousebird	0	4	0	4
mrVanDalo	https://github.com/mrVanDalo	1	0	0	1
mrmachine	https://github.com/mrmachine	1	0	0	1
mrmagooey	https://github.com/mrmagooey	1	0	0	1
msnelling	https://github.com/msnelling	1	0	0	1
mstembera	https://github.com/mstembera	1	0	0	1
mtwebster	https://github.com/mtwebster	0	1	0	1
multiscan	https://github.com/multiscan	1	0	0	1
murtazavf	https://github.com/murtazavf	1	0	0	1
myak-soft	https://github.com/myak-soft	1	0	0	1
myself248	https://github.com/myself248	2	0	0	2
mythodeia	https://github.com/mythodeia	1	0	0	1
nateabele	https://github.com/nateabele	0	17	0	17
nateirwin	https://github.com/nateirwin	1	2	0	3
nathanvda	https://github.com/nathanvda	0	1	0	1
netzpirat	https://github.com/netzpirat	0	2	0	2
nicinabox	https://github.com/nicinabox	0	2	0	2
nickarsov	https://github.com/nickarsov	1	0	0	1
nickholub	https://github.com/nickholub	4	4	0	8
nicolas-f	https://github.com/nicolas-f	0	1	0	1
nightwing	https://github.com/nightwing	0	1	0	1
nitriques	https://github.com/nitriques	0	1	0	1
nnarhinen	https://github.com/nnarhinen	0	1	0	1
nomospace	https://github.com/nomospace	1	0	0	1
norman784	https://github.com/norman784	1	0	0	1
notbryant	https://github.com/notbryant	1	0	0	1
ntherning	https://github.com/ntherning	0	3	0	3
nyantarou	https://github.com/nyantarou	10	0	0	10
ole-tange	https://github.com/ole-tange	1	4	0	5
oleksandr	https://github.com/oleksandr	1	0	0	1
orangeman	https://github.com/orangeman	1	0	0	1
orobardet	https://github.com/orobardet	0	2	0	2
osiris123	https://github.com/osiris123	0	3	0	3
ostraaten	https://github.com/ostraaten	1	0	0	1
oxtoacart	https://github.com/oxtoacart	1	1	0	2
pablinhob	https://github.com/pablinhob	3	0	0	3
paraenggu	https://github.com/paraenggu	1	0	0	1
paranoida	https://github.com/paranoida	1	0	0	1
parcollet	https://github.com/parcollet	2	0	0	2
patrickmj	https://github.com/patrickmj	2	0	0	2
patwonder	https://github.com/patwonder	0	1	0	1
paulhayes	https://github.com/paulhayes	1	0	0	1
paulhoule	https://github.com/paulhoule	1	0	0	1
paulstaab	https://github.com/paulstaab	0	1	0	1
paulyoung	https://github.com/paulyoung	1	0	0	1
pd-nmoser	https://github.com/pd-nmoser	4	1	0	5
penibelst	https://github.com/penibelst	0	1	0	1
perwendel	https://github.com/perwendel	0	2	0	2
phil88530	https://github.com/phil88530	1	0	0	1
phillipsm	https://github.com/phillipsm	2	0	0	2
philstark	https://github.com/philstark	1	0	0	1
phoenixx2	https://github.com/phoenixx2	0	1	0	1
pipwilson	https://github.com/pipwilson	0	1	0	1
pixelroot	https://github.com/pixelroot	1	0	0	1
pixelzoom	https://github.com/pixelzoom	4	2	2	8
pkolmykov	https://github.com/pkolmykov	5	1	0	6
plastboks	https://github.com/plastboks	1	2	0	3
pmeridian	https://github.com/pmeridian	0	1	1	2
pparidans	https://github.com/pparidans	1	0	0	1
praseodym	https://github.com/praseodym	1	0	0	1
professor	https://github.com/professor	1	0	0	1
proprocek	https://github.com/proprocek	1	0	0	1
prymitive	https://github.com/prymitive	0	1	0	1
pslestang	https://github.com/pslestang	1	1	0	2
punitsoni	https://github.com/punitsoni	1	0	0	1
purpleD17	https://github.com/purpleD17	1	0	0	1
qdelettre	https://github.com/qdelettre	1	0	0	1
quarnster	https://github.com/quarnster	1	0	0	1
quintesse	https://github.com/quintesse	3	3	0	6
rackerjoe	https://github.com/rackerjoe	0	1	0	1
rchekaluk	https://github.com/rchekaluk	1	0	0	1
renatoroz	https://github.com/renatoroz	4	0	0	4
ribasushi	https://github.com/ribasushi	1	0	0	1
ricefield	https://github.com/ricefield	2	2	0	4
richardhj	https://github.com/richardhj	1	0	0	1
rivanenko	https://github.com/rivanenko	1	0	0	1
robbiegod	https://github.com/robbiegod	1	0	0	1
robbyronk	https://github.com/robbyronk	0	1	0	1
robhudson	https://github.com/robhudson	1	1	0	2
robjwells	https://github.com/robjwells	0	1	0	1
roblafeve	https://github.com/roblafeve	0	3	0	3
roblarsen	https://github.com/roblarsen	0	1	0	1
rodfersou	https://github.com/rodfersou	1	6	0	7
rogerwang	https://github.com/rogerwang	0	2	0	2
romikoops	https://github.com/romikoops	1	0	0	1
roryokane	https://github.com/roryokane	1	0	0	1
rossnanop	https://github.com/rossnanop	1	0	0	1
roundhill	https://github.com/roundhill	2	0	0	2
rpalcolea	https://github.com/rpalcolea	1	0	0	1
rsamantha	https://github.com/rsamantha	0	1	0	1
rswharton	https://github.com/rswharton	1	0	0	1
rwcarlsen	https://github.com/rwcarlsen	0	1	0	1
s0undt3ch	https://github.com/s0undt3ch	0	1	0	1
s9tpepper	https://github.com/s9tpepper	0	3	0	3
sableloki	https://github.com/sableloki	3	0	0	3
sabre1041	https://github.com/sabre1041	1	0	0	1
sabrinang	https://github.com/sabrinang	1	0	0	1
sachazyto	https://github.com/sachazyto	2	0	0	2
sachishah	https://github.com/sachishah	1	0	0	1
saikojosh	https://github.com/saikojosh	3	2	0	5
saman-ghm	https://github.com/saman-ghm	2	0	0	2
samclarke	https://github.com/samclarke	0	3	0	3
sampleYan	https://github.com/sampleYan	1	0	0	1
sampowers	https://github.com/sampowers	0	1	0	1
sanctityQ	https://github.com/sanctityQ	0	6	0	6
santagada	https://github.com/santagada	5	0	0	5
santiniki	https://github.com/santiniki	1	1	0	2
santyclaz	https://github.com/santyclaz	0	1	0	1
sarahkemp	https://github.com/sarahkemp	1	0	0	1
saravanaj	https://github.com/saravanaj	1	0	0	1
sasha2002	https://github.com/sasha2002	1	0	0	1
sauanimal	https://github.com/sauanimal	6	0	0	6
sbichenko	https://github.com/sbichenko	1	0	0	1
sbshields	https://github.com/sbshields	1	0	0	1
schleumer	https://github.com/schleumer	1	0	0	1
scott0228	https://github.com/scott0228	1	0	0	1
scottzer0	https://github.com/scottzer0	1	0	0	1
sdumitriu	https://github.com/sdumitriu	0	2	0	2
sebaortiz	https://github.com/sebaortiz	1	0	0	1
sebcrozet	https://github.com/sebcrozet	0	1	0	1
sebduggan	https://github.com/sebduggan	2	0	0	2
sgress454	https://github.com/sgress454	0	1	0	1
shcarrico	https://github.com/shcarrico	1	0	0	1
shibukawa	https://github.com/shibukawa	1	0	0	1
shinji257	https://github.com/shinji257	2	0	0	2
shirataki	https://github.com/shirataki	1	0	0	1
shootermv	https://github.com/shootermv	0	1	0	1
sidorares	https://github.com/sidorares	0	1	0	1
sigmundch	https://github.com/sigmundch	0	3	0	3
simlegate	https://github.com/simlegate	0	2	0	2
simonwade	https://github.com/simonwade	1	0	0	1
sintanial	https://github.com/sintanial	1	0	0	1
sithtoast	https://github.com/sithtoast	2	1	0	3
skolesnyk	https://github.com/skolesnyk	1	0	0	1
skstudios	https://github.com/skstudios	1	0	0	1
slandelle	https://github.com/slandelle	5	5	0	10
smuzaffar	https://github.com/smuzaffar	0	1	0	1
snakeduse	https://github.com/snakeduse	3	0	0	3
snowmantw	https://github.com/snowmantw	3	2	0	5
softprops	https://github.com/softprops	0	1	0	1
spacedman	https://github.com/spacedman	0	2	0	2
spicyjack	https://github.com/spicyjack	1	0	0	1
srinathgs	https://github.com/srinathgs	1	1	0	2
ssafejava	https://github.com/ssafejava	0	1	0	1
sschepens	https://github.com/sschepens	1	0	0	1
staygrimm	https://github.com/staygrimm	1	0	0	1
stemkoski	https://github.com/stemkoski	0	3	0	3
stenehall	https://github.com/stenehall	0	1	0	1
stewGlass	https://github.com/stewGlass	0	2	1	3
successus	https://github.com/successus	4	1	0	5
sunweaver	https://github.com/sunweaver	1	0	0	1
supertux1	https://github.com/supertux1	1	0	0	1
sylturner	https://github.com/sylturner	0	1	0	1
tagomoris	https://github.com/tagomoris	1	3	0	4
taigi0909	https://github.com/taigi0909	1	0	0	1
talbright	https://github.com/talbright	1	0	0	1
tatarinov	https://github.com/tatarinov	0	1	0	1
taylortbb	https://github.com/taylortbb	3	1	0	4
tbarbugli	https://github.com/tbarbugli	1	0	0	1
tbergeron	https://github.com/tbergeron	1	1	0	2
tcheng001	https://github.com/tcheng001	1	5	0	6
tdonelson	https://github.com/tdonelson	1	0	0	1
teleyinex	https://github.com/teleyinex	1	0	0	1
tgriesser	https://github.com/tgriesser	0	1	0	1
themerius	https://github.com/themerius	5	0	0	5
thibaudgg	https://github.com/thibaudgg	0	5	0	5
tigerzhou	https://github.com/tigerzhou	1	0	0	1
tim-evans	https://github.com/tim-evans	1	0	0	1
timsutton	https://github.com/timsutton	0	1	0	1
timwaters	https://github.com/timwaters	1	0	0	1
tmilewski	https://github.com/tmilewski	0	4	0	4
tokuhirom	https://github.com/tokuhirom	0	2	0	2
tomgjones	https://github.com/tomgjones	1	0	0	1
tomhughes	https://github.com/tomhughes	0	2	0	2
tomsquest	https://github.com/tomsquest	1	0	0	1
tomsturge	https://github.com/tomsturge	1	0	0	1
troessner	https://github.com/troessner	0	1	0	1
trsteel88	https://github.com/trsteel88	0	1	0	1
tsgautier	https://github.com/tsgautier	1	0	0	1
turdparty	https://github.com/turdparty	1	0	0	1
tyl210110	https://github.com/tyl210110	1	0	0	1
uberbrodt	https://github.com/uberbrodt	1	0	0	1
unclejack	https://github.com/unclejack	1	0	0	1
user-none	https://github.com/user-none	1	0	0	1
val99erie	https://github.com/val99erie	0	4	0	4
ventouris	https://github.com/ventouris	1	0	0	1
viatropos	https://github.com/viatropos	0	1	0	1
vigsterkr	https://github.com/vigsterkr	0	3	0	3
vincent4j	https://github.com/vincent4j	1	1	0	2
vinniemac	https://github.com/vinniemac	1	0	0	1
vivekiiit	https://github.com/vivekiiit	2	0	0	2
vividcode	https://github.com/vividcode	0	1	0	1
vmarrazzo	https://github.com/vmarrazzo	1	0	0	1
vmeurisse	https://github.com/vmeurisse	1	0	0	1
vujadin23	https://github.com/vujadin23	1	0	0	1
wangframe	https://github.com/wangframe	1	0	0	1
wearpants	https://github.com/wearpants	0	5	0	5
wesleycho	https://github.com/wesleycho	1	0	0	1
whitebook	https://github.com/whitebook	1	1	0	2
wibeasley	https://github.com/wibeasley	5	1	0	6
willdages	https://github.com/willdages	1	1	0	2
wimstefan	https://github.com/wimstefan	1	0	0	1
withlovee	https://github.com/withlovee	2	0	0	2
wolfgangw	https://github.com/wolfgangw	0	1	0	1
wpalahnuk	https://github.com/wpalahnuk	1	0	0	1
wzh005313	https://github.com/wzh005313	1	0	0	1
xinlangzi	https://github.com/xinlangzi	1	0	0	1
xponrails	https://github.com/xponrails	1	0	0	1
yayitswei	https://github.com/yayitswei	1	0	0	1
yetuweiba	https://github.com/yetuweiba	1	0	0	1
yinpengji	https://github.com/yinpengji	1	0	0	1
ylansegal	https://github.com/ylansegal	1	0	0	1
yudiakbar	https://github.com/yudiakbar	1	0	0	1
yulomakin	https://github.com/yulomakin	0	1	0	1
yungsters	https://github.com/yungsters	0	1	0	1
yvesbauer	https://github.com/yvesbauer	1	1	0	2
yyang-src	https://github.com/yyang-src	1	0	0	1
zackbloom	https://github.com/zackbloom	1	1	0	2
zakdances	https://github.com/zakdances	1	3	0	4
zenorocha	https://github.com/zenorocha	5	5	0	10
zero21xxx	https://github.com/zero21xxx	0	1	0	1
ziellos2k	https://github.com/ziellos2k	0	1	0	1
zinzinday	https://github.com/zinzinday	0	1	1	2
zionshine	https://github.com/zionshine	1	1	0	2
ztmonster	https://github.com/ztmonster	1	0	0	1
zushenyan	https://github.com/zushenyan	0	1	0	1
zzdhidden	https://github.com/zzdhidden	0	9	0	9
8bitweapon	https://github.com/8bitweapon	1	0	0	1
9mmtylenol	https://github.com/9mmtylenol	1	0	0	1
AJ-Acevedo	https://github.com/AJ-Acevedo	1	0	0	1
AKindyakov	https://github.com/AKindyakov	0	1	0	1
AnnaGerber	https://github.com/AnnaGerber	0	1	0	1
Anonym-tsk	https://github.com/Anonym-tsk	0	1	0	1
AntonTrapp	https://github.com/AntonTrapp	0	1	0	1
Aranclanos	https://github.com/Aranclanos	0	1	0	1
ArnedeBoer	https://github.com/ArnedeBoer	5	3	0	8
Azerothian	https://github.com/Azerothian	1	1	0	2
Babelfisch	https://github.com/Babelfisch	1	0	0	1
BillWagner	https://github.com/BillWagner	1	0	0	1
Bloodsplat	https://github.com/Bloodsplat	0	5	0	5
BrightPaul	https://github.com/BrightPaul	1	0	0	1
Buffaloron	https://github.com/Buffaloron	1	0	0	1
CachingFoX	https://github.com/CachingFoX	7	9	0	16
Cardude419	https://github.com/Cardude419	1	0	0	1
Carlitta87	https://github.com/Carlitta87	1	1	0	2
Cedric0303	https://github.com/Cedric0303	1	0	0	1
CodingUnit	https://github.com/CodingUnit	0	1	0	1
ColinZhang	https://github.com/ColinZhang	3	2	0	5
Corona4456	https://github.com/Corona4456	1	0	0	1
CrazyPants	https://github.com/CrazyPants	0	4	0	4
Cthulahoop	https://github.com/Cthulahoop	3	0	0	3
D-1-hacker	https://github.com/D-1-hacker	1	0	0	1
DWvanGeest	https://github.com/DWvanGeest	0	1	0	1
DaBungalow	https://github.com/DaBungalow	1	1	0	2
Damianofds	https://github.com/Damianofds	1	1	0	2
DannySklar	https://github.com/DannySklar	1	1	1	3
DavidGamba	https://github.com/DavidGamba	1	0	0	1
DavidJotta	https://github.com/DavidJotta	1	0	0	1
DavidLeoni	https://github.com/DavidLeoni	2	1	0	3
DavidWells	https://github.com/DavidWells	1	0	0	1
DisposaBoy	https://github.com/DisposaBoy	0	1	0	1
DrMoriarty	https://github.com/DrMoriarty	1	0	0	1
EdwardBock	https://github.com/EdwardBock	4	4	0	8
ElliottJRo	https://github.com/ElliottJRo	3	1	0	4
ErnieAtLYD	https://github.com/ErnieAtLYD	0	1	0	1
EvgeniyMsk	https://github.com/EvgeniyMsk	2	0	0	2
FarrelBuch	https://github.com/FarrelBuch	2	1	1	4
Fauntleroy	https://github.com/Fauntleroy	1	0	0	1
FredtheRed	https://github.com/FredtheRed	1	0	0	1
GAFletcher	https://github.com/GAFletcher	1	1	1	3
GKBelmonte	https://github.com/GKBelmonte	6	1	0	7
GavinJoyce	https://github.com/GavinJoyce	1	0	0	1
GeekShadow	https://github.com/GeekShadow	2	1	0	3
Groovounet	https://github.com/Groovounet	0	1	0	1
HetIsNiels	https://github.com/HetIsNiels	1	0	0	1
HoloAddict	https://github.com/HoloAddict	0	1	0	1
HowardCohl	https://github.com/HowardCohl	2	0	0	2
Hypercubed	https://github.com/Hypercubed	0	5	0	5
Ironarcher	https://github.com/Ironarcher	0	0	1	1
JackPrince	https://github.com/JackPrince	1	1	0	2
JechoJekov	https://github.com/JechoJekov	1	0	0	1
JeffHoover	https://github.com/JeffHoover	1	0	0	1
Jianru-Lin	https://github.com/Jianru-Lin	1	0	0	1
JoeAlisson	https://github.com/JoeAlisson	0	1	0	1
JohnHBrock	https://github.com/JohnHBrock	0	3	0	3
JustMe0815	https://github.com/JustMe0815	1	0	0	1
KGardevoir	https://github.com/KGardevoir	1	0	0	1
LegitTalon	https://github.com/LegitTalon	1	1	0	2
LoveGitHub	https://github.com/LoveGitHub	1	0	0	1
Mailaender	https://github.com/Mailaender	2	1	0	3
MakinLumio	https://github.com/MakinLumio	1	0	0	1
MarcoXoops	https://github.com/MarcoXoops	1	0	0	1
MarioVilas	https://github.com/MarioVilas	1	0	0	1
MasterEjay	https://github.com/MasterEjay	1	0	0	1
MaxHasADHD	https://github.com/MaxHasADHD	2	2	0	4
MetalMatze	https://github.com/MetalMatze	1	0	0	1
NETZkultur	https://github.com/NETZkultur	1	0	0	1
Nathan2055	https://github.com/Nathan2055	1	0	0	1
NucleaPeon	https://github.com/NucleaPeon	1	0	0	1
PaulKinlan	https://github.com/PaulKinlan	1	1	0	2
Person8880	https://github.com/Person8880	0	2	0	2
Pluxopolis	https://github.com/Pluxopolis	0	1	0	1
PoPoutdoor	https://github.com/PoPoutdoor	1	0	0	1
Prashanfdo	https://github.com/Prashanfdo	1	0	0	1
RaphaelDDL	https://github.com/RaphaelDDL	1	0	0	1
Ratstail91	https://github.com/Ratstail91	0	2	0	2
RaymondLim	https://github.com/RaymondLim	1	0	0	1
RealRancor	https://github.com/RealRancor	2	0	0	2
RigoFlores	https://github.com/RigoFlores	1	1	0	2
RobotAmiee	https://github.com/RobotAmiee	1	0	0	1
RodionGork	https://github.com/RodionGork	1	3	0	4
RubyLouvre	https://github.com/RubyLouvre	0	1	0	1
RuudBurger	https://github.com/RuudBurger	0	8	0	8
SIneaCalin	https://github.com/SIneaCalin	1	0	0	1
SamoylovMD	https://github.com/SamoylovMD	2	0	0	2
Sidnicious	https://github.com/Sidnicious	1	0	0	1
SimonCropp	https://github.com/SimonCropp	0	1	0	1
SlavaBobik	https://github.com/SlavaBobik	0	1	0	1
Someguy123	https://github.com/Someguy123	2	0	0	2
SoulBeaver	https://github.com/SoulBeaver	1	0	0	1
Spiritwind	https://github.com/Spiritwind	1	0	0	1
SteveyPugs	https://github.com/SteveyPugs	1	0	0	1
Sufrostico	https://github.com/Sufrostico	0	1	1	2
Talamantez	https://github.com/Talamantez	1	0	0	1
TurboLance	https://github.com/TurboLance	2	0	0	2
Undergarun	https://github.com/Undergarun	1	1	0	2
UnixJunkie	https://github.com/UnixJunkie	1	0	0	1
Vanessa219	https://github.com/Vanessa219	1	1	0	2
Wattermann	https://github.com/Wattermann	0	11	0	11
Wolfenswan	https://github.com/Wolfenswan	1	2	0	3
Wolfsrudel	https://github.com/Wolfsrudel	2	0	0	2
a-belevich	https://github.com/a-belevich	0	1	0	1
a-chumagin	https://github.com/a-chumagin	0	0	1	1
abackstrom	https://github.com/abackstrom	1	0	0	1
acliss19xx	https://github.com/acliss19xx	0	1	0	1
adammarton	https://github.com/adammarton	1	0	0	1
adamnbowen	https://github.com/adamnbowen	1	0	0	1
adamretter	https://github.com/adamretter	1	1	0	2
adamrights	https://github.com/adamrights	1	0	0	1
adreghiciu	https://github.com/adreghiciu	0	1	0	1
adrianfish	https://github.com/adrianfish	1	0	0	1
advertwine	https://github.com/advertwine	1	0	0	1
aknishiumi	https://github.com/aknishiumi	2	0	0	2
alanpearce	https://github.com/alanpearce	1	0	0	1
ali-graham	https://github.com/ali-graham	0	1	0	1
almirfilho	https://github.com/almirfilho	0	1	0	1
alonswartz	https://github.com/alonswartz	0	2	0	2
ametaireau	https://github.com/ametaireau	1	2	0	3
ancestorak	https://github.com/ancestorak	3	0	0	3
andrei4002	https://github.com/andrei4002	1	0	0	1
andyinabox	https://github.com/andyinabox	1	0	0	1
ankurankan	https://github.com/ankurankan	2	1	0	3
anupcowkur	https://github.com/anupcowkur	0	1	0	1
apazzolini	https://github.com/apazzolini	0	2	0	2
apokalipto	https://github.com/apokalipto	0	1	0	1
arcimboldo	https://github.com/arcimboldo	1	0	0	1
aredington	https://github.com/aredington	1	0	0	1
argriffing	https://github.com/argriffing	0	1	0	1
ariunbayar	https://github.com/ariunbayar	0	1	0	1
artdude543	https://github.com/artdude543	1	0	0	1
arthur-liu	https://github.com/arthur-liu	1	0	0	1
aschroeder	https://github.com/aschroeder	4	1	0	5
asika32764	https://github.com/asika32764	1	0	0	1
asimarslan	https://github.com/asimarslan	0	1	0	1
avstudnitz	https://github.com/avstudnitz	1	1	0	2
awidegreen	https://github.com/awidegreen	1	0	0	1
bartjacobs	https://github.com/bartjacobs	1	0	0	1
bayboi1020	https://github.com/bayboi1020	1	0	0	1
ben-github	https://github.com/ben-github	0	1	0	1
benaxelrod	https://github.com/benaxelrod	1	0	0	1
benoitdion	https://github.com/benoitdion	1	1	0	2
benschwarz	https://github.com/benschwarz	0	1	0	1
bensheldon	https://github.com/bensheldon	2	0	0	2
benwilliam	https://github.com/benwilliam	0	1	0	1
betanalpha	https://github.com/betanalpha	1	0	0	1
bighostkim	https://github.com/bighostkim	6	4	0	10
billbonney	https://github.com/billbonney	2	0	0	2
bit-pirate	https://github.com/bit-pirate	2	0	0	2
bluebomber	https://github.com/bluebomber	2	0	0	2
brendanhay	https://github.com/brendanhay	0	1	0	1
brettatoms	https://github.com/brettatoms	2	0	0	2
brockallen	https://github.com/brockallen	0	1	0	1
bschuedzig	https://github.com/bschuedzig	1	0	0	1
bskinny129	https://github.com/bskinny129	1	0	0	1
burtonator	https://github.com/burtonator	1	0	0	1
buyer111us	https://github.com/buyer111us	1	0	0	1
caiogondim	https://github.com/caiogondim	1	0	0	1
caitbonnar	https://github.com/caitbonnar	1	0	0	1
cakeller98	https://github.com/cakeller98	1	0	0	1
calebgomer	https://github.com/calebgomer	16	3	0	19
campbellpj	https://github.com/campbellpj	1	0	0	1
cantrecall	https://github.com/cantrecall	1	1	0	2
capalmer85	https://github.com/capalmer85	1	0	0	1
captainrad	https://github.com/captainrad	1	0	0	1
carter2422	https://github.com/carter2422	6	0	0	6
cbankester	https://github.com/cbankester	1	0	0	1
cburroughs	https://github.com/cburroughs	1	0	0	1
chamzzzzzz	https://github.com/chamzzzzzz	13	5	0	18
chantastic	https://github.com/chantastic	1	0	0	1
chengdujin	https://github.com/chengdujin	1	0	0	1
chenyupeng	https://github.com/chenyupeng	1	1	0	2
choptastic	https://github.com/choptastic	1	0	0	1
cincypiper	https://github.com/cincypiper	1	0	0	1
cmprogrock	https://github.com/cmprogrock	1	0	0	1
coenjacobs	https://github.com/coenjacobs	0	2	1	3
cognominal	https://github.com/cognominal	1	0	0	1
come-raczy	https://github.com/come-raczy	0	1	0	1
commonsguy	https://github.com/commonsguy	1	0	1	2
cramdesign	https://github.com/cramdesign	1	0	0	1
creationix	https://github.com/creationix	3	0	0	3
csantanapr	https://github.com/csantanapr	0	1	0	1
cullymason	https://github.com/cullymason	1	2	0	3
curtishall	https://github.com/curtishall	1	0	0	1
curvedmark	https://github.com/curvedmark	1	0	0	1
cwjohnston	https://github.com/cwjohnston	2	0	0	2
cyberdelia	https://github.com/cyberdelia	1	0	0	1
danepowell	https://github.com/danepowell	0	1	0	1
danhaywood	https://github.com/danhaywood	1	0	0	1
danielhers	https://github.com/danielhers	1	0	0	1
danielkerr	https://github.com/danielkerr	0	5	0	5
danielrozo	https://github.com/danielrozo	0	1	0	1
danipralea	https://github.com/danipralea	1	0	0	1
darrinkatz	https://github.com/darrinkatz	2	0	0	2
davecramer	https://github.com/davecramer	0	1	0	1
davidalger	https://github.com/davidalger	1	0	0	1
davidcelis	https://github.com/davidcelis	1	3	0	4
daviddavis	https://github.com/daviddavis	1	0	0	1
davidoesch	https://github.com/davidoesch	11	0	0	11
davidswelt	https://github.com/davidswelt	3	0	0	3
davydotcom	https://github.com/davydotcom	0	2	0	2
dcardosods	https://github.com/dcardosods	1	1	0	2
ddeconinck	https://github.com/ddeconinck	1	0	0	1
deanberris	https://github.com/deanberris	0	6	0	6
deanohyeah	https://github.com/deanohyeah	0	7	0	7
deepblueli	https://github.com/deepblueli	1	0	0	1
deepsweech	https://github.com/deepsweech	1	0	0	1
denisboyun	https://github.com/denisboyun	0	1	0	1
deparis719	https://github.com/deparis719	1	0	0	1
derekdhaas	https://github.com/derekdhaas	1	0	0	1
devinrader	https://github.com/devinrader	0	1	0	1
devoncarew	https://github.com/devoncarew	0	1	0	1
dezinezync	https://github.com/dezinezync	1	2	0	3
dfuentes77	https://github.com/dfuentes77	1	0	0	1
dhaval-vnc	https://github.com/dhaval-vnc	0	1	0	1
diegonehab	https://github.com/diegonehab	0	3	0	3
digital006	https://github.com/digital006	4	1	0	5
discordier	https://github.com/discordier	1	0	0	1
djibouti33	https://github.com/djibouti33	0	1	0	1
dkulchenko	https://github.com/dkulchenko	1	0	0	1
dlundquist	https://github.com/dlundquist	0	1	0	1
dmahapatro	https://github.com/dmahapatro	1	0	0	1
dmcdougall	https://github.com/dmcdougall	1	1	0	2
dongilbert	https://github.com/dongilbert	1	0	0	1
dotnetwise	https://github.com/dotnetwise	1	0	0	1
douglasjam	https://github.com/douglasjam	1	0	0	1
doutriaux1	https://github.com/doutriaux1	0	2	0	2
dragon100a	https://github.com/dragon100a	1	0	0	1
drapergeek	https://github.com/drapergeek	3	0	0	3
dreikanter	https://github.com/dreikanter	7	1	0	8
drtortoise	https://github.com/drtortoise	1	0	0	1
dubsquared	https://github.com/dubsquared	1	0	0	1
duckinator	https://github.com/duckinator	1	0	0	1
edoardo849	https://github.com/edoardo849	2	2	0	4
edusantana	https://github.com/edusantana	1	0	0	1
effykingly	https://github.com/effykingly	0	1	0	1
eightlines	https://github.com/eightlines	1	0	0	1
elmindreda	https://github.com/elmindreda	0	1	0	1
emanuele45	https://github.com/emanuele45	0	1	0	1
emschwartz	https://github.com/emschwartz	2	0	0	2
eoinmiller	https://github.com/eoinmiller	1	0	0	1
eonpatapon	https://github.com/eonpatapon	0	1	0	1
ergonlogic	https://github.com/ergonlogic	1	0	0	1
ericbrooke	https://github.com/ericbrooke	1	0	0	1
ericfaurot	https://github.com/ericfaurot	0	2	0	2
erinrwhite	https://github.com/erinrwhite	2	0	0	2
erosenfeld	https://github.com/erosenfeld	1	0	0	1
evanchooly	https://github.com/evanchooly	0	3	0	3
evantahler	https://github.com/evantahler	2	3	0	5
fabien0102	https://github.com/fabien0102	0	2	0	2
fabiogiaco	https://github.com/fabiogiaco	1	0	0	1
fangeugene	https://github.com/fangeugene	0	1	0	1
firewaller	https://github.com/firewaller	1	0	0	1
fivetanley	https://github.com/fivetanley	0	1	0	1
flankerhqd	https://github.com/flankerhqd	1	0	0	1
flashman71	https://github.com/flashman71	3	0	0	3
fluidsonic	https://github.com/fluidsonic	1	0	0	1
foklepoint	https://github.com/foklepoint	1	0	0	1
foreverdra	https://github.com/foreverdra	1	0	0	1
frankiekam	https://github.com/frankiekam	2	0	0	2
frozenfoxx	https://github.com/frozenfoxx	1	0	0	1
fschoening	https://github.com/fschoening	1	0	0	1
fusion2004	https://github.com/fusion2004	1	0	0	1
gabraganca	https://github.com/gabraganca	0	1	0	1
generalm13	https://github.com/generalm13	1	0	0	1
gentisaliu	https://github.com/gentisaliu	0	1	0	1
gordonsyme	https://github.com/gordonsyme	1	0	0	1
grantlucas	https://github.com/grantlucas	1	0	0	1
greenrobot	https://github.com/greenrobot	0	1	0	1
gregbenner	https://github.com/gregbenner	1	1	0	2
grimmwerks	https://github.com/grimmwerks	1	0	0	1
gruzzilkin	https://github.com/gruzzilkin	1	0	0	1
gwhitehawk	https://github.com/gwhitehawk	1	0	0	1
hammermaps	https://github.com/hammermaps	0	1	0	1
harsaharsa	https://github.com/harsaharsa	0	2	1	3
herrstucki	https://github.com/herrstucki	1	0	0	1
heyitsnoah	https://github.com/heyitsnoah	1	0	0	1
hijackwang	https://github.com/hijackwang	1	0	0	1
hiroshiyui	https://github.com/hiroshiyui	0	1	0	1
hitsthings	https://github.com/hitsthings	1	0	0	1
hoppfrosch	https://github.com/hoppfrosch	4	0	0	4
hseeberger	https://github.com/hseeberger	0	1	0	1
huangz1990	https://github.com/huangz1990	0	1	0	1
hueniverse	https://github.com/hueniverse	4	4	0	8
hyh1048576	https://github.com/hyh1048576	1	0	0	1
hysoftware	https://github.com/hysoftware	1	0	0	1
iamgreaser	https://github.com/iamgreaser	1	0	0	1
iamjayanth	https://github.com/iamjayanth	1	0	0	1
iammerrick	https://github.com/iammerrick	1	0	0	1
iammichiel	https://github.com/iammichiel	1	0	0	1
idbygeorge	https://github.com/idbygeorge	0	1	0	1
idpaterson	https://github.com/idpaterson	1	0	0	1
idreeskhan	https://github.com/idreeskhan	1	0	0	1
iesportada	https://github.com/iesportada	0	1	0	1
illmasterc	https://github.com/illmasterc	1	0	0	1
ilovemytee	https://github.com/ilovemytee	1	0	0	1
imabasghar	https://github.com/imabasghar	1	0	0	1
imjoshdean	https://github.com/imjoshdean	0	1	0	1
inactivist	https://github.com/inactivist	1	1	0	2
indyarocks	https://github.com/indyarocks	1	0	0	1
insanehong	https://github.com/insanehong	0	1	0	1
interoneca	https://github.com/interoneca	1	0	0	1
ipodishima	https://github.com/ipodishima	0	2	0	2
ivaniacono	https://github.com/ivaniacono	0	1	0	1
jackmcdade	https://github.com/jackmcdade	1	0	0	1
jakealstad	https://github.com/jakealstad	1	0	0	1
jamesgecko	https://github.com/jamesgecko	1	0	0	1
jantheofel	https://github.com/jantheofel	1	0	0	1
jarosser06	https://github.com/jarosser06	1	0	0	1
jasonkuhrt	https://github.com/jasonkuhrt	3	0	0	3
javismiles	https://github.com/javismiles	1	1	0	2
jaymedavis	https://github.com/jaymedavis	0	1	0	1
jdorweiler	https://github.com/jdorweiler	1	0	0	1
jean-m-cyr	https://github.com/jean-m-cyr	0	1	0	1
jeffbonnes	https://github.com/jeffbonnes	0	1	0	1
jel-massih	https://github.com/jel-massih	7	0	0	7
jenjackson	https://github.com/jenjackson	2	0	0	2
jenlampton	https://github.com/jenlampton	8	0	0	8
jenssegers	https://github.com/jenssegers	0	3	0	3
jeremyfelt	https://github.com/jeremyfelt	1	0	0	1
jeroenooms	https://github.com/jeroenooms	0	2	0	2
jfirebaugh	https://github.com/jfirebaugh	1	1	0	2
jgambarios	https://github.com/jgambarios	0	1	0	1
jgonggrijp	https://github.com/jgonggrijp	0	1	0	1
jiang11958	https://github.com/jiang11958	1	0	0	1
jlerpscher	https://github.com/jlerpscher	0	1	0	1
jlsherrill	https://github.com/jlsherrill	1	0	0	1
joachimvda	https://github.com/joachimvda	0	3	0	3
joefiorini	https://github.com/joefiorini	4	4	0	8
joelkuiper	https://github.com/joelkuiper	1	1	0	2
joeyfigaro	https://github.com/joeyfigaro	0	1	0	1
johnashto9	https://github.com/johnashto9	1	0	0	1
johnfelipe	https://github.com/johnfelipe	2	0	0	2
johnhaddon	https://github.com/johnhaddon	0	1	0	1
johnpbloch	https://github.com/johnpbloch	1	1	0	2
johnsimons	https://github.com/johnsimons	1	0	0	1
jokeofweek	https://github.com/jokeofweek	0	0	1	1
jondkinney	https://github.com/jondkinney	1	0	0	1
joneslee85	https://github.com/joneslee85	1	0	0	1
jonnenauha	https://github.com/jonnenauha	1	0	0	1
jonpmarino	https://github.com/jonpmarino	1	0	0	1
jonsabados	https://github.com/jonsabados	0	1	0	1
jonyeunghk	https://github.com/jonyeunghk	1	1	0	2
josecoelho	https://github.com/josecoelho	1	1	0	2
josifovics	https://github.com/josifovics	1	0	0	1
jousterde1	https://github.com/jousterde1	0	1	0	1
jpmckinney	https://github.com/jpmckinney	0	1	0	1
jtmkrueger	https://github.com/jtmkrueger	1	0	0	1
juanpabloe	https://github.com/juanpabloe	3	1	0	4
julianhyde	https://github.com/julianhyde	1	1	0	2
julianozen	https://github.com/julianozen	4	1	0	5
justzx2011	https://github.com/justzx2011	0	5	0	5
jwineinger	https://github.com/jwineinger	1	0	0	1
karanlyons	https://github.com/karanlyons	0	1	0	1
karatektus	https://github.com/karatektus	1	0	0	1
karlito139	https://github.com/karlito139	2	0	0	2
kawaiiwolf	https://github.com/kawaiiwolf	1	0	0	1
kellyelton	https://github.com/kellyelton	0	2	0	2
keshavarzi	https://github.com/keshavarzi	5	1	0	6
kevzettler	https://github.com/kevzettler	1	0	0	1
kgignatyev	https://github.com/kgignatyev	1	0	0	1
kingargyle	https://github.com/kingargyle	2	1	0	3
kingchurch	https://github.com/kingchurch	0	1	0	1
kirilligum	https://github.com/kirilligum	0	1	0	1
ktoanlba89	https://github.com/ktoanlba89	1	1	0	2
lanstudios	https://github.com/lanstudios	1	0	0	1
larrybotha	https://github.com/larrybotha	1	0	0	1
laserlemon	https://github.com/laserlemon	0	1	0	1
laubsauger	https://github.com/laubsauger	1	0	0	1
lhazlewood	https://github.com/lhazlewood	1	0	0	1
lifesinger	https://github.com/lifesinger	0	1	0	1
lilahagyma	https://github.com/lilahagyma	0	1	0	1
lingdecong	https://github.com/lingdecong	1	0	0	1
linhuiling	https://github.com/linhuiling	15	0	0	15
littleboss	https://github.com/littleboss	1	0	0	1
lmarburger	https://github.com/lmarburger	0	1	0	1
loadedsith	https://github.com/loadedsith	1	0	0	1
luanjunior	https://github.com/luanjunior	1	1	0	2
lukesutton	https://github.com/lukesutton	1	1	0	2
luoshupeng	https://github.com/luoshupeng	1	0	0	1
mac-cain13	https://github.com/mac-cain13	1	0	0	1
marcoberri	https://github.com/marcoberri	1	0	0	1
marcosutra	https://github.com/marcosutra	0	1	0	1
mariovisic	https://github.com/mariovisic	0	1	0	1
markbrough	https://github.com/markbrough	1	0	0	1
markhealey	https://github.com/markhealey	1	0	0	1
marplesoft	https://github.com/marplesoft	1	0	0	1
martinvega	https://github.com/martinvega	2	0	0	2
mateusazis	https://github.com/mateusazis	5	2	0	7
mathiaslin	https://github.com/mathiaslin	1	0	0	1
mattsparks	https://github.com/mattsparks	1	0	0	1
mattstiles	https://github.com/mattstiles	1	1	0	2
mauriel133	https://github.com/mauriel133	0	1	0	1
max-arnold	https://github.com/max-arnold	2	0	0	2
maxdemarzi	https://github.com/maxdemarzi	0	1	0	1
maxmouchet	https://github.com/maxmouchet	2	1	0	3
mclark4386	https://github.com/mclark4386	1	1	0	2
mdedetrich	https://github.com/mdedetrich	1	0	0	1
meltingice	https://github.com/meltingice	0	1	0	1
metrodango	https://github.com/metrodango	0	1	0	1
mewdriller	https://github.com/mewdriller	3	1	0	4
mgeorgescu	https://github.com/mgeorgescu	0	1	0	1
mgrebenets	https://github.com/mgrebenets	1	1	0	2
michaelaye	https://github.com/michaelaye	1	0	0	1
michaelmdf	https://github.com/michaelmdf	1	0	0	1
michalwski	https://github.com/michalwski	1	0	0	1
miguelcanm	https://github.com/miguelcanm	0	2	0	2
mikehadlow	https://github.com/mikehadlow	0	3	0	3
mikejolley	https://github.com/mikejolley	0	4	0	4
mistydemeo	https://github.com/mistydemeo	0	0	1	1
miyabihito	https://github.com/miyabihito	2	2	0	4
miyasakago	https://github.com/miyasakago	1	0	0	1
mkdarkness	https://github.com/mkdarkness	3	0	0	3
mkroehnert	https://github.com/mkroehnert	3	0	0	3
mlekomleko	https://github.com/mlekomleko	2	0	0	2
mobilemail	https://github.com/mobilemail	1	0	0	1
mobilemind	https://github.com/mobilemind	1	0	0	1
mondkaefer	https://github.com/mondkaefer	1	0	0	1
monnierant	https://github.com/monnierant	1	0	0	1
mookid8000	https://github.com/mookid8000	0	1	0	1
moorepants	https://github.com/moorepants	3	0	0	3
morninlark	https://github.com/morninlark	1	0	0	1
mpharrigan	https://github.com/mpharrigan	0	1	0	1
mrdonthave	https://github.com/mrdonthave	1	0	0	1
mreiferson	https://github.com/mreiferson	1	0	0	1
mrreynolds	https://github.com/mrreynolds	0	1	0	1
mtotschnig	https://github.com/mtotschnig	1	0	0	1
mwarhaftig	https://github.com/mwarhaftig	1	0	0	1
mwildehahn	https://github.com/mwildehahn	1	0	0	1
myszkowski	https://github.com/myszkowski	2	0	0	2
naresh1283	https://github.com/naresh1283	1	0	0	1
nasenatmer	https://github.com/nasenatmer	1	0	0	1
nbuytaert1	https://github.com/nbuytaert1	2	0	0	2
nddrylliog	https://github.com/nddrylliog	0	1	0	1
ndmitchell	https://github.com/ndmitchell	0	1	0	1
netpoetica	https://github.com/netpoetica	1	0	0	1
nickebbutt	https://github.com/nickebbutt	0	5	0	5
nickmerwin	https://github.com/nickmerwin	0	3	0	3
noiseunion	https://github.com/noiseunion	1	0	0	1
norihiro-w	https://github.com/norihiro-w	1	0	0	1
nostalgiaz	https://github.com/nostalgiaz	0	1	0	1
ohyecloudy	https://github.com/ohyecloudy	1	0	0	1
oldskool73	https://github.com/oldskool73	1	0	0	1
oliver----	https://github.com/oliver----	0	1	0	1
ollyjsmith	https://github.com/ollyjsmith	0	4	0	4
omarhaffar	https://github.com/omarhaffar	1	0	0	1
omidgharib	https://github.com/omidgharib	1	0	0	1
opoplawski	https://github.com/opoplawski	1	0	0	1
oskarrough	https://github.com/oskarrough	2	0	0	2
ovillellas	https://github.com/ovillellas	0	1	0	1
parkerault	https://github.com/parkerault	1	1	0	2
patrickyan	https://github.com/patrickyan	1	0	0	1
paulcbetts	https://github.com/paulcbetts	1	1	0	2
paulfurley	https://github.com/paulfurley	0	1	0	1
paulswartz	https://github.com/paulswartz	1	0	0	1
pavelbinar	https://github.com/pavelbinar	1	0	0	1
peterflynn	https://github.com/peterflynn	3	0	0	3
phillee007	https://github.com/phillee007	1	0	0	1
phungleson	https://github.com/phungleson	0	1	0	1
polinas123	https://github.com/polinas123	1	0	0	1
postmodern	https://github.com/postmodern	0	1	0	1
powdahound	https://github.com/powdahound	0	1	0	1
predakanga	https://github.com/predakanga	1	0	0	1
psullivan6	https://github.com/psullivan6	1	1	0	2
purigarcia	https://github.com/purigarcia	1	0	0	1
pushmatrix	https://github.com/pushmatrix	0	1	1	2
quentffr21	https://github.com/quentffr21	1	0	0	1
rafaacheti	https://github.com/rafaacheti	7	0	0	7
rafaeladel	https://github.com/rafaeladel	1	0	0	1
rajaths589	https://github.com/rajaths589	1	1	0	2
ramonakira	https://github.com/ramonakira	1	0	0	1
ramtel2005	https://github.com/ramtel2005	1	0	0	1
rasmusfl0e	https://github.com/rasmusfl0e	1	0	0	1
raulfraile	https://github.com/raulfraile	0	1	0	1
ravivyas84	https://github.com/ravivyas84	1	1	0	2
rcbjenkins	https://github.com/rcbjenkins	0	1	0	1
rdennis463	https://github.com/rdennis463	0	1	0	1
redihokuto	https://github.com/redihokuto	1	0	0	1
relaxdiego	https://github.com/relaxdiego	2	0	0	2
repeatedly	https://github.com/repeatedly	0	2	0	2
returnzero	https://github.com/returnzero	1	0	0	1
revolverXD	https://github.com/revolverXD	1	0	0	1
ripe-denis	https://github.com/ripe-denis	0	1	0	1
rivercheng	https://github.com/rivercheng	1	0	0	1
rob-gordon	https://github.com/rob-gordon	1	0	0	1
robertdall	https://github.com/robertdall	1	1	0	2
robertmeta	https://github.com/robertmeta	1	1	0	2
robinkraft	https://github.com/robinkraft	1	1	0	2
robotslave	https://github.com/robotslave	0	7	0	7
rochaporto	https://github.com/rochaporto	1	0	0	1
roderik333	https://github.com/roderik333	1	0	0	1
rogerbinns	https://github.com/rogerbinns	2	0	0	2
rolandinsh	https://github.com/rolandinsh	1	0	0	1
rom-melnyk	https://github.com/rom-melnyk	1	0	0	1
romanofski	https://github.com/romanofski	3	0	0	3
ronniedong	https://github.com/ronniedong	0	2	0	2
roughcoder	https://github.com/roughcoder	0	1	0	1
rskvirskiy	https://github.com/rskvirskiy	1	0	0	1
rusvicious	https://github.com/rusvicious	1	0	0	1
ryangallen	https://github.com/ryangallen	1	0	0	1
ryaniskira	https://github.com/ryaniskira	1	0	0	1
rzimmerman	https://github.com/rzimmerman	3	4	0	7
s-takehana	https://github.com/s-takehana	0	1	0	1
safetys123	https://github.com/safetys123	1	0	0	1
samalloing	https://github.com/samalloing	1	0	0	1
sbonnegent	https://github.com/sbonnegent	1	1	0	2
schickling	https://github.com/schickling	0	2	0	2
schumi2004	https://github.com/schumi2004	1	0	0	1
sdosemagen	https://github.com/sdosemagen	2	0	0	2
seekerquoc	https://github.com/seekerquoc	1	0	0	1
seifsallam	https://github.com/seifsallam	1	0	0	1
selvam1991	https://github.com/selvam1991	0	1	0	1
sfonteneau	https://github.com/sfonteneau	1	0	0	1
sgriffiths	https://github.com/sgriffiths	1	0	0	1
shahbaz777	https://github.com/shahbaz777	1	0	0	1
shanselman	https://github.com/shanselman	1	0	0	1
shuishoumu	https://github.com/shuishoumu	1	0	0	1
simonwelsh	https://github.com/simonwelsh	1	0	0	1
simonwiles	https://github.com/simonwiles	1	0	0	1
simplyluke	https://github.com/simplyluke	1	0	0	1
smileclick	https://github.com/smileclick	1	0	0	1
sonicparke	https://github.com/sonicparke	1	0	0	1
specialp89	https://github.com/specialp89	1	0	0	1
spikebrehm	https://github.com/spikebrehm	0	1	0	1
spiritdead	https://github.com/spiritdead	1	1	0	2
squirrelfm	https://github.com/squirrelfm	1	1	0	2
srcshelton	https://github.com/srcshelton	0	2	0	2
stephenmcd	https://github.com/stephenmcd	0	1	0	1
stephenway	https://github.com/stephenway	2	0	0	2
steve228uk	https://github.com/steve228uk	1	0	0	1
stevellion	https://github.com/stevellion	1	0	0	1
stonedmind	https://github.com/stonedmind	3	2	0	5
stoneharry	https://github.com/stoneharry	0	1	0	1
strannik-j	https://github.com/strannik-j	1	0	0	1
sueloverso	https://github.com/sueloverso	2	0	0	2
sumitverma	https://github.com/sumitverma	1	0	0	1
sumyungguy	https://github.com/sumyungguy	1	0	0	1
sunchyme20	https://github.com/sunchyme20	1	0	0	1
superbobry	https://github.com/superbobry	1	0	0	1
superjirre	https://github.com/superjirre	0	1	0	1
svenkeidel	https://github.com/svenkeidel	0	1	0	1
syj2010syj	https://github.com/syj2010syj	1	0	0	1
synergetic	https://github.com/synergetic	1	0	0	1
synhershko	https://github.com/synhershko	2	0	0	2
syntellect	https://github.com/syntellect	2	0	0	2
tarekziade	https://github.com/tarekziade	2	3	0	5
tariqislam	https://github.com/tariqislam	0	2	0	2
tduchateau	https://github.com/tduchateau	0	1	0	1
tfernandez	https://github.com/tfernandez	1	0	0	1
thecubical	https://github.com/thecubical	1	0	0	1
thenetgray	https://github.com/thenetgray	1	0	0	1
thestinger	https://github.com/thestinger	3	6	0	9
thomaspons	https://github.com/thomaspons	1	0	0	1
timorzadir	https://github.com/timorzadir	1	0	0	1
timwindsor	https://github.com/timwindsor	0	1	0	1
timzagelow	https://github.com/timzagelow	1	0	0	1
tjchambers	https://github.com/tjchambers	0	0	1	1
toddbranch	https://github.com/toddbranch	1	0	0	1
tomas-knap	https://github.com/tomas-knap	4	2	0	6
tombentley	https://github.com/tombentley	3	5	0	8
tomgreever	https://github.com/tomgreever	2	1	0	3
tonymorris	https://github.com/tonymorris	1	0	0	1
tractorcow	https://github.com/tractorcow	0	1	0	1
transforme	https://github.com/transforme	1	0	0	1
traverseda	https://github.com/traverseda	3	1	0	4
treffynnon	https://github.com/treffynnon	0	1	0	1
treyhunner	https://github.com/treyhunner	1	0	0	1
tricknotes	https://github.com/tricknotes	1	0	0	1
trolldbois	https://github.com/trolldbois	1	0	0	1
tucson-tom	https://github.com/tucson-tom	1	0	0	1
ucchyocean	https://github.com/ucchyocean	2	0	0	2
uroatienza	https://github.com/uroatienza	7	0	0	7
uweschmitt	https://github.com/uweschmitt	1	0	0	1
vagifverdi	https://github.com/vagifverdi	1	0	0	1
vasikgreif	https://github.com/vasikgreif	1	0	0	1
vernnobile	https://github.com/vernnobile	2	1	0	3
victusfate	https://github.com/victusfate	0	1	0	1
virusbb001	https://github.com/virusbb001	0	1	0	1
vkostyukov	https://github.com/vkostyukov	0	2	0	2
vmwinckler	https://github.com/vmwinckler	1	0	0	1
w137000133	https://github.com/w137000133	1	0	0	1
wallarelvo	https://github.com/wallarelvo	0	1	0	1
wangbin579	https://github.com/wangbin579	0	1	0	1
wangyixian	https://github.com/wangyixian	0	2	0	2
warren5236	https://github.com/warren5236	2	0	0	2
weaverryan	https://github.com/weaverryan	0	1	0	1
wickyhasan	https://github.com/wickyhasan	1	0	0	1
wildabeast	https://github.com/wildabeast	0	1	0	1
willdurand	https://github.com/willdurand	0	2	0	2
willywongi	https://github.com/willywongi	1	0	0	1
xinhaoyuan	https://github.com/xinhaoyuan	0	1	0	1
yangwenmai	https://github.com/yangwenmai	1	0	0	1
yanivyalda	https://github.com/yanivyalda	1	0	0	1
yarikoptic	https://github.com/yarikoptic	1	0	0	1
yendor5691	https://github.com/yendor5691	1	0	0	1
yinbaodian	https://github.com/yinbaodian	0	6	0	6
yoshie902a	https://github.com/yoshie902a	0	1	0	1
youknowone	https://github.com/youknowone	1	0	0	1
youngshook	https://github.com/youngshook	1	0	0	1
zachelrath	https://github.com/zachelrath	1	0	0	1
zhaozijian	https://github.com/zhaozijian	0	0	1	1
zhuravljov	https://github.com/zhuravljov	0	1	0	1
zwaldowski	https://github.com/zwaldowski	0	1	0	1
zyberspace	https://github.com/zyberspace	15	3	0	18
zyndiecate	https://github.com/zyndiecate	1	0	0	1
1d3df9903ad	https://github.com/1d3df9903ad	2	0	0	2
1manStartup	https://github.com/1manStartup	1	0	0	1
1ndivisible	https://github.com/1ndivisible	1	0	0	1
200Creative	https://github.com/200Creative	0	1	1	2
ADDCreative	https://github.com/ADDCreative	0	1	0	1
AlbertMoben	https://github.com/AlbertMoben	1	0	0	1
Alec-Sobeck	https://github.com/Alec-Sobeck	0	1	0	1
AlejandroJD	https://github.com/AlejandroJD	1	0	0	1
AlexSchwank	https://github.com/AlexSchwank	1	0	0	1
AlfredGerke	https://github.com/AlfredGerke	1	0	0	1
AndrewRadev	https://github.com/AndrewRadev	0	1	0	1
AngryLawyer	https://github.com/AngryLawyer	0	1	0	1
ArnoldZokas	https://github.com/ArnoldZokas	2	2	0	4
BenSibelman	https://github.com/BenSibelman	0	0	1	1
BentPLarsen	https://github.com/BentPLarsen	1	0	0	1
BexPerchard	https://github.com/BexPerchard	0	1	0	1
BjarniRunar	https://github.com/BjarniRunar	0	3	0	3
BoonsNaibot	https://github.com/BoonsNaibot	1	0	0	1
BorisNaguet	https://github.com/BorisNaguet	1	0	0	1
BravoEncore	https://github.com/BravoEncore	1	0	0	1
BrianGallew	https://github.com/BrianGallew	1	0	0	1
Bulwersator	https://github.com/Bulwersator	10	0	0	10
BuschFunker	https://github.com/BuschFunker	1	0	0	1
BuysTooMuch	https://github.com/BuysTooMuch	1	0	0	1
ByteFlinger	https://github.com/ByteFlinger	0	1	0	1
Capncavedan	https://github.com/Capncavedan	1	0	0	1
CathyMacars	https://github.com/CathyMacars	1	0	0	1
Cheefrocker	https://github.com/Cheefrocker	1	0	0	1
ChrisMissal	https://github.com/ChrisMissal	0	2	0	2
Cocoanetics	https://github.com/Cocoanetics	1	5	0	6
CodeInsider	https://github.com/CodeInsider	1	0	0	1
CopticWalad	https://github.com/CopticWalad	1	0	0	1
Dachande663	https://github.com/Dachande663	0	1	0	1
DanLanglois	https://github.com/DanLanglois	1	0	0	1
Daniel-Diaz	https://github.com/Daniel-Diaz	1	0	0	1
DaveSanders	https://github.com/DaveSanders	1	0	0	1
DavidFeliot	https://github.com/DavidFeliot	2	0	0	2
DavidRagone	https://github.com/DavidRagone	1	1	0	2
DavydenkovM	https://github.com/DavydenkovM	0	1	0	1
DeveloperUX	https://github.com/DeveloperUX	0	1	0	1
DiogoDoreto	https://github.com/DiogoDoreto	1	1	0	2
EricSharkey	https://github.com/EricSharkey	1	0	0	1
ExodusDeath	https://github.com/ExodusDeath	1	0	0	1
First-blood	https://github.com/First-blood	1	0	0	1
Flashnukers	https://github.com/Flashnukers	1	0	0	1
FreifunkUFO	https://github.com/FreifunkUFO	1	1	0	2
Furious1964	https://github.com/Furious1964	1	0	0	1
Guillaume11	https://github.com/Guillaume11	1	0	0	1
HappyComedy	https://github.com/HappyComedy	1	0	0	1
Higorhicaro	https://github.com/Higorhicaro	1	0	0	1
Husterknupp	https://github.com/Husterknupp	2	1	0	3
Ingannatore	https://github.com/Ingannatore	0	1	0	1
Integralist	https://github.com/Integralist	1	0	0	1
IonicaBizau	https://github.com/IonicaBizau	1	2	0	3
IronTetsubo	https://github.com/IronTetsubo	2	0	0	2
IsrraBanton	https://github.com/IsrraBanton	0	2	0	2
JacksonTian	https://github.com/JacksonTian	0	2	0	2
JakeWharton	https://github.com/JakeWharton	0	3	1	4
JaredSartin	https://github.com/JaredSartin	1	0	0	1
JohnBrookes	https://github.com/JohnBrookes	0	1	0	1
Kassandra12	https://github.com/Kassandra12	0	1	0	1
Kirkhammett	https://github.com/Kirkhammett	0	1	0	1
KnightBaron	https://github.com/KnightBaron	1	0	0	1
LennartMart	https://github.com/LennartMart	1	2	0	3
LucasMagnum	https://github.com/LucasMagnum	0	1	0	1
LuizArmesto	https://github.com/LuizArmesto	0	6	0	6
LynnaWaters	https://github.com/LynnaWaters	1	0	0	1
MedicalTest	https://github.com/MedicalTest	3	0	0	3
MetinSeylan	https://github.com/MetinSeylan	1	0	0	1
MichaelSARP	https://github.com/MichaelSARP	1	0	0	1
Mikedeleeuw	https://github.com/Mikedeleeuw	5	1	0	6
MiladQamari	https://github.com/MiladQamari	1	0	0	1
Misterlogan	https://github.com/Misterlogan	1	0	0	1
MitzyTorres	https://github.com/MitzyTorres	1	1	0	2
NicoDevynck	https://github.com/NicoDevynck	0	1	0	1
Ninjakannon	https://github.com/Ninjakannon	0	1	0	1
OrangeShark	https://github.com/OrangeShark	1	2	0	3
OscarGodson	https://github.com/OscarGodson	2	1	0	3
PavelBastov	https://github.com/PavelBastov	0	1	0	1
PeterPan133	https://github.com/PeterPan133	1	0	0	1
PuerkitoBio	https://github.com/PuerkitoBio	0	1	0	1
Restless-ET	https://github.com/Restless-ET	1	0	0	1
Ricardo1980	https://github.com/Ricardo1980	1	0	0	1
RobertDober	https://github.com/RobertDober	4	3	0	7
RobertElder	https://github.com/RobertElder	1	0	0	1
Rodgerwilco	https://github.com/Rodgerwilco	2	1	0	3
Romaindavid	https://github.com/Romaindavid	16	0	0	16
Serpentsoft	https://github.com/Serpentsoft	1	0	0	1
ShadoFlameX	https://github.com/ShadoFlameX	0	1	0	1
ShawnMcCool	https://github.com/ShawnMcCool	0	1	0	1
SimonGoring	https://github.com/SimonGoring	5	0	0	5
SkyBirdSoar	https://github.com/SkyBirdSoar	0	2	0	2
SlaunchaMan	https://github.com/SlaunchaMan	1	0	0	1
SmashBrando	https://github.com/SmashBrando	1	0	0	1
SnowDog2003	https://github.com/SnowDog2003	3	0	0	3
SteveVallay	https://github.com/SteveVallay	0	1	0	1
StratoPulse	https://github.com/StratoPulse	1	0	0	1
Tenebrosity	https://github.com/Tenebrosity	1	0	0	1
TheIronMarx	https://github.com/TheIronMarx	1	0	0	1
TheOnlyJoey	https://github.com/TheOnlyJoey	1	0	0	1
TobyHowarth	https://github.com/TobyHowarth	1	0	0	1
TristanTrim	https://github.com/TristanTrim	1	0	0	1
Tungstwenty	https://github.com/Tungstwenty	1	0	0	1
VijayGaddam	https://github.com/VijayGaddam	1	0	0	1
Vuccappella	https://github.com/Vuccappella	2	0	0	2
Wolvereness	https://github.com/Wolvereness	5	3	0	8
WonderCsabo	https://github.com/WonderCsabo	3	0	0	3
WraithKenny	https://github.com/WraithKenny	1	0	0	1
ZeRodriguez	https://github.com/ZeRodriguez	6	2	0	8
aaronlidman	https://github.com/aaronlidman	1	0	0	1
aaronwalker	https://github.com/aaronwalker	0	2	0	2
abbaspalash	https://github.com/abbaspalash	1	0	0	1
aboudreault	https://github.com/aboudreault	0	1	0	1
aclark4life	https://github.com/aclark4life	0	1	0	1
activescott	https://github.com/activescott	0	1	0	1
adamdaubney	https://github.com/adamdaubney	2	0	0	2
addictgamer	https://github.com/addictgamer	0	2	0	2
ainemcguire	https://github.com/ainemcguire	1	0	0	1
akshayjshah	https://github.com/akshayjshah	1	0	0	1
alain-andre	https://github.com/alain-andre	1	0	0	1
alainfrisch	https://github.com/alainfrisch	1	0	0	1
albatrocity	https://github.com/albatrocity	0	4	0	4
alecperkins	https://github.com/alecperkins	2	0	0	2
alekseyfrom	https://github.com/alekseyfrom	1	0	0	1
alessioalex	https://github.com/alessioalex	3	5	0	8
alex22hayes	https://github.com/alex22hayes	1	0	0	1
alexrussell	https://github.com/alexrussell	1	0	0	1
alexsdutton	https://github.com/alexsdutton	1	0	0	1
alfrenovsky	https://github.com/alfrenovsky	1	0	0	1
aliceingame	https://github.com/aliceingame	1	0	0	1
alvingarcia	https://github.com/alvingarcia	1	0	0	1
alvloureiro	https://github.com/alvloureiro	1	0	0	1
americanyak	https://github.com/americanyak	1	1	0	2
amir-zeldes	https://github.com/amir-zeldes	2	0	0	2
anandpdoshi	https://github.com/anandpdoshi	1	0	0	1
andrewclegg	https://github.com/andrewclegg	1	0	0	1
andrewseidl	https://github.com/andrewseidl	4	0	0	4
andydandy74	https://github.com/andydandy74	1	0	0	1
anilgulecha	https://github.com/anilgulecha	1	0	0	1
anilgupta84	https://github.com/anilgupta84	1	0	0	1
animehunter	https://github.com/animehunter	3	0	0	3
annewootton	https://github.com/annewootton	1	0	0	1
aristidesfl	https://github.com/aristidesfl	1	0	0	1
aventurella	https://github.com/aventurella	1	0	0	1
awestendorf	https://github.com/awestendorf	0	1	0	1
barisusakli	https://github.com/barisusakli	1	1	0	2
barryhughes	https://github.com/barryhughes	0	0	1	1
bastienMPDL	https://github.com/bastienMPDL	2	3	0	5
bbuckingham	https://github.com/bbuckingham	1	0	0	1
beaucollins	https://github.com/beaucollins	1	1	0	2
benbjohnson	https://github.com/benbjohnson	0	1	0	1
benlangfeld	https://github.com/benlangfeld	1	0	0	1
binarybabel	https://github.com/binarybabel	1	0	0	1
binarybucks	https://github.com/binarybucks	2	0	0	2
blakdronzer	https://github.com/blakdronzer	1	0	0	1
bluegoblin7	https://github.com/bluegoblin7	10	0	0	10
bobdenotter	https://github.com/bobdenotter	1	3	0	4
bozhidarmyh	https://github.com/bozhidarmyh	1	0	0	1
breestealth	https://github.com/breestealth	0	1	0	1
brendandahl	https://github.com/brendandahl	0	2	0	2
brendandoxo	https://github.com/brendandoxo	1	0	0	1
bretjackson	https://github.com/bretjackson	2	0	0	2
brndnmtthws	https://github.com/brndnmtthws	1	0	0	1
bruceharris	https://github.com/bruceharris	1	0	0	1
brunoamaral	https://github.com/brunoamaral	1	1	0	2
brunomiguel	https://github.com/brunomiguel	1	1	0	2
bryantlikes	https://github.com/bryantlikes	1	0	0	1
camiloperic	https://github.com/camiloperic	1	0	0	1
carpodaster	https://github.com/carpodaster	1	0	1	2
cferdinandi	https://github.com/cferdinandi	0	1	0	1
charmingzuo	https://github.com/charmingzuo	1	0	0	1
chimbosonic	https://github.com/chimbosonic	1	0	0	1
chris-grove	https://github.com/chris-grove	1	1	0	2
chris-smith	https://github.com/chris-smith	1	0	0	1
chrisinajar	https://github.com/chrisinajar	4	1	0	5
chrismerris	https://github.com/chrismerris	1	0	0	1
chrismwendt	https://github.com/chrismwendt	0	1	0	1
chrisnatali	https://github.com/chrisnatali	0	1	0	1
chrissnyder	https://github.com/chrissnyder	1	0	0	1
chrisvfritz	https://github.com/chrisvfritz	1	0	0	1
cincodenada	https://github.com/cincodenada	1	0	0	1
citizenmatt	https://github.com/citizenmatt	1	0	0	1
citricsquid	https://github.com/citricsquid	1	0	0	1
clayallsopp	https://github.com/clayallsopp	0	1	0	1
coderespawn	https://github.com/coderespawn	1	0	0	1
coderhaoxin	https://github.com/coderhaoxin	3	0	0	3
commuterjoy	https://github.com/commuterjoy	1	0	0	1
conejoninja	https://github.com/conejoninja	0	1	0	1
cookiecraft	https://github.com/cookiecraft	2	0	0	2
corydorning	https://github.com/corydorning	1	0	0	1
cubieplayer	https://github.com/cubieplayer	1	17	1	19
cybersiddhu	https://github.com/cybersiddhu	1	0	0	1
cycomachead	https://github.com/cycomachead	1	0	0	1
dalvirsaini	https://github.com/dalvirsaini	2	0	0	2
danialfarid	https://github.com/danialfarid	0	3	0	3
danielaixer	https://github.com/danielaixer	0	1	0	1
danielnaber	https://github.com/danielnaber	1	0	0	1
danielzilli	https://github.com/danielzilli	1	0	0	1
danmatthews	https://github.com/danmatthews	1	0	0	1
dannystaple	https://github.com/dannystaple	2	1	0	3
datacarepro	https://github.com/datacarepro	3	3	0	6
daurnimator	https://github.com/daurnimator	1	0	0	1
davepacheco	https://github.com/davepacheco	1	1	0	2
daveybravey	https://github.com/daveybravey	1	0	0	1
davidbenton	https://github.com/davidbenton	1	0	0	1
davidfestal	https://github.com/davidfestal	0	1	0	1
davidmccabe	https://github.com/davidmccabe	1	0	0	1
dcunited001	https://github.com/dcunited001	1	0	0	1
deathlord87	https://github.com/deathlord87	1	0	0	1
dermeister0	https://github.com/dermeister0	1	0	0	1
desarrolla2	https://github.com/desarrolla2	1	0	0	1
devalicious	https://github.com/devalicious	8	1	0	9
deviousdodo	https://github.com/deviousdodo	1	0	0	1
devongovett	https://github.com/devongovett	0	1	0	1
dexterpratt	https://github.com/dexterpratt	1	7	0	8
diegoviola1	https://github.com/diegoviola1	1	0	0	1
dinhviethoa	https://github.com/dinhviethoa	1	4	0	5
dirk-thomas	https://github.com/dirk-thomas	1	1	0	2
donatqueens	https://github.com/donatqueens	0	2	0	2
donszelmann	https://github.com/donszelmann	0	3	0	3
dougfleming	https://github.com/dougfleming	1	2	0	3
dougrdotnet	https://github.com/dougrdotnet	1	0	0	1
dragondagda	https://github.com/dragondagda	1	0	0	1
drapostolos	https://github.com/drapostolos	2	0	0	2
drixselecta	https://github.com/drixselecta	1	0	0	1
drummer3333	https://github.com/drummer3333	0	1	0	1
drunkhacker	https://github.com/drunkhacker	1	3	0	4
dschuermann	https://github.com/dschuermann	21	14	0	35
dylanfprice	https://github.com/dylanfprice	0	1	0	1
dylanjbarth	https://github.com/dylanjbarth	2	0	0	2
eddiefisher	https://github.com/eddiefisher	1	0	0	1
edgeloyalty	https://github.com/edgeloyalty	1	0	0	1
elainethale	https://github.com/elainethale	0	1	0	1
elliotpotts	https://github.com/elliotpotts	1	0	0	1
elliotwoods	https://github.com/elliotwoods	3	1	0	4
ellisonleao	https://github.com/ellisonleao	1	0	0	1
eternaltyro	https://github.com/eternaltyro	1	0	0	1
etorreborre	https://github.com/etorreborre	0	1	0	1
facultymatt	https://github.com/facultymatt	2	1	0	3
ferlinhusky	https://github.com/ferlinhusky	0	1	0	1
flaviamissi	https://github.com/flaviamissi	1	1	0	2
fndomariano	https://github.com/fndomariano	2	0	0	2
freddejones	https://github.com/freddejones	1	3	0	4
freeride280	https://github.com/freeride280	1	0	0	1
fungiblecog	https://github.com/fungiblecog	1	0	0	1
fxaeberhard	https://github.com/fxaeberhard	4	5	0	9
gareth-rees	https://github.com/gareth-rees	2	2	0	4
garrynewman	https://github.com/garrynewman	0	1	0	1
garysieling	https://github.com/garysieling	5	0	0	5
garysweaver	https://github.com/garysweaver	0	1	0	1
gblackMitre	https://github.com/gblackMitre	0	1	0	1
geremyCohen	https://github.com/geremyCohen	0	2	0	2
ginatrapani	https://github.com/ginatrapani	0	3	0	3
ginjaninja1	https://github.com/ginjaninja1	1	0	0	1
giovaandrea	https://github.com/giovaandrea	1	0	0	1
githubsmilo	https://github.com/githubsmilo	1	1	0	2
gizmotronic	https://github.com/gizmotronic	0	1	0	1
gluklichman	https://github.com/gluklichman	2	0	0	2
gnistdesign	https://github.com/gnistdesign	1	0	0	1
grantemsley	https://github.com/grantemsley	1	0	0	1
greenleader	https://github.com/greenleader	1	0	0	1
grzesiekmos	https://github.com/grzesiekmos	0	1	1	2
gurgelrenan	https://github.com/gurgelrenan	1	0	0	1
hanshoglund	https://github.com/hanshoglund	7	3	0	10
harshavarma	https://github.com/harshavarma	1	0	0	1
helenvarley	https://github.com/helenvarley	0	1	0	1
hellogerard	https://github.com/hellogerard	1	0	0	1
henrikbjorn	https://github.com/henrikbjorn	0	2	0	2
highfeeling	https://github.com/highfeeling	2	2	0	4
hishammalik	https://github.com/hishammalik	0	1	0	1
houseofzeus	https://github.com/houseofzeus	0	0	1	1
hunterowens	https://github.com/hunterowens	1	0	0	1
illicomedia	https://github.com/illicomedia	1	0	0	1
indevizible	https://github.com/indevizible	1	0	0	1
ipostanogov	https://github.com/ipostanogov	1	0	0	1
ivaylokenov	https://github.com/ivaylokenov	0	1	0	1
jairofsouza	https://github.com/jairofsouza	1	0	0	1
jakubklimek	https://github.com/jakubklimek	2	5	0	7
jamesalbert	https://github.com/jamesalbert	0	2	0	2
jamesarosen	https://github.com/jamesarosen	0	1	0	1
jameswilson	https://github.com/jameswilson	1	0	0	1
janwijbrand	https://github.com/janwijbrand	1	0	0	1
jarofghosts	https://github.com/jarofghosts	1	0	0	1
javisantana	https://github.com/javisantana	1	1	0	2
jayseventwo	https://github.com/jayseventwo	1	0	0	1
jbailey2010	https://github.com/jbailey2010	6	0	0	6
jefffischer	https://github.com/jefffischer	0	1	0	1
jeremyselan	https://github.com/jeremyselan	1	0	0	1
jimsproject	https://github.com/jimsproject	1	0	0	1
jiyinyiyong	https://github.com/jiyinyiyong	2	0	0	2
jliebermann	https://github.com/jliebermann	1	0	0	1
jmatsushita	https://github.com/jmatsushita	2	2	0	4
jmlemetayer	https://github.com/jmlemetayer	4	0	0	4
joachimmetz	https://github.com/joachimmetz	2	0	0	2
joaogabriel	https://github.com/joaogabriel	5	0	0	5
joelrbrandt	https://github.com/joelrbrandt	1	0	0	1
johnnyquest	https://github.com/johnnyquest	2	0	0	2
jonathanong	https://github.com/jonathanong	1	9	0	10
jonkristian	https://github.com/jonkristian	1	0	0	1
jorin-vogel	https://github.com/jorin-vogel	1	4	0	5
josephspens	https://github.com/josephspens	4	2	0	6
juliotaylor	https://github.com/juliotaylor	1	0	0	1
kalisjoshua	https://github.com/kalisjoshua	9	2	0	11
karabijavad	https://github.com/karabijavad	1	0	0	1
kardkovacsi	https://github.com/kardkovacsi	1	1	0	2
karolherbst	https://github.com/karolherbst	0	1	0	1
kastiglione	https://github.com/kastiglione	1	1	0	2
keithbostic	https://github.com/keithbostic	0	1	0	1
kenshiuechi	https://github.com/kenshiuechi	1	0	0	1
kevinSuttle	https://github.com/kevinSuttle	1	0	0	1
kgeographer	https://github.com/kgeographer	1	0	0	1
kikutiandre	https://github.com/kikutiandre	1	0	0	1
kimeswenger	https://github.com/kimeswenger	0	1	0	1
kittykiller	https://github.com/kittykiller	1	0	0	1
klahnakoski	https://github.com/klahnakoski	0	1	0	1
klamontagne	https://github.com/klamontagne	1	0	0	1
kmhcreative	https://github.com/kmhcreative	1	0	0	1
knownasilya	https://github.com/knownasilya	1	0	0	1
korsvanloon	https://github.com/korsvanloon	1	0	0	1
krampstudio	https://github.com/krampstudio	0	1	0	1
krasnoukhov	https://github.com/krasnoukhov	0	1	0	1
krestenkrab	https://github.com/krestenkrab	1	0	0	1
kunalbalani	https://github.com/kunalbalani	1	0	0	1
kurisuwhyte	https://github.com/kurisuwhyte	1	0	0	1
kwaledesign	https://github.com/kwaledesign	2	0	0	2
kylejohnson	https://github.com/kylejohnson	1	0	0	1
lalitkapoor	https://github.com/lalitkapoor	1	1	0	2
lasitha1991	https://github.com/lasitha1991	0	1	0	1
laurikimmel	https://github.com/laurikimmel	0	1	0	1
littlelazer	https://github.com/littlelazer	2	0	0	2
lloydwatkin	https://github.com/lloydwatkin	2	1	0	3
louismullie	https://github.com/louismullie	0	1	0	1
lukas-vlcek	https://github.com/lukas-vlcek	0	1	0	1
lukeredpath	https://github.com/lukeredpath	1	4	0	5
macournoyer	https://github.com/macournoyer	0	4	0	4
maherkassim	https://github.com/maherkassim	3	0	0	3
maikelwever	https://github.com/maikelwever	1	0	0	1
malteseduck	https://github.com/malteseduck	2	0	0	2
marek-surek	https://github.com/marek-surek	1	0	0	1
markathomas	https://github.com/markathomas	1	0	0	1
markcornick	https://github.com/markcornick	1	0	0	1
marksievers	https://github.com/marksievers	1	0	0	1
martinbooth	https://github.com/martinbooth	1	0	0	1
maselpopowo	https://github.com/maselpopowo	2	2	0	4
matthewelse	https://github.com/matthewelse	0	1	0	1
mattupstate	https://github.com/mattupstate	2	0	0	2
mbroecheler	https://github.com/mbroecheler	1	1	0	2
metalivedev	https://github.com/metalivedev	1	0	0	1
michaelfung	https://github.com/michaelfung	0	2	0	2
miguelpeixe	https://github.com/miguelpeixe	1	2	0	3
mikemcquaid	https://github.com/mikemcquaid	0	2	0	2
mikepatrick	https://github.com/mikepatrick	0	3	0	3
milanraulim	https://github.com/milanraulim	1	0	0	1
miloandmilk	https://github.com/miloandmilk	1	1	0	2
mindplay-dk	https://github.com/mindplay-dk	3	2	0	5
mmoussallam	https://github.com/mmoussallam	1	2	0	3
mohitbhoite	https://github.com/mohitbhoite	0	4	0	4
mojavelinux	https://github.com/mojavelinux	1	0	0	1
monkeypants	https://github.com/monkeypants	2	0	0	2
montrezorro	https://github.com/montrezorro	0	1	0	1
mosesonline	https://github.com/mosesonline	1	0	0	1
mvillagordo	https://github.com/mvillagordo	0	1	0	1
myleshorton	https://github.com/myleshorton	0	2	0	2
negrosombra	https://github.com/negrosombra	1	0	0	1
ngehlenborg	https://github.com/ngehlenborg	5	0	0	5
nickjackson	https://github.com/nickjackson	2	0	0	2
nicoleglynn	https://github.com/nicoleglynn	8	0	0	8
nicoschtein	https://github.com/nicoschtein	0	1	0	1
ninetwozero	https://github.com/ninetwozero	0	1	0	1
nixterrimus	https://github.com/nixterrimus	1	0	0	1
oloflarsson	https://github.com/oloflarsson	0	2	0	2
omarshammas	https://github.com/omarshammas	0	3	0	3
onierstrasz	https://github.com/onierstrasz	1	0	0	1
ortuagustin	https://github.com/ortuagustin	0	1	0	1
patrikarlos	https://github.com/patrikarlos	1	0	0	1
paulddraper	https://github.com/paulddraper	2	0	0	2
paulmwatson	https://github.com/paulmwatson	1	2	0	3
paulrblakey	https://github.com/paulrblakey	1	0	0	1
pencilcheck	https://github.com/pencilcheck	1	0	0	1
photonstorm	https://github.com/photonstorm	1	0	0	1
pombredanne	https://github.com/pombredanne	1	0	0	1
poweruser82	https://github.com/poweruser82	1	0	0	1
pranav-gopi	https://github.com/pranav-gopi	0	1	0	1
preinheimer	https://github.com/preinheimer	1	0	0	1
psychobunny	https://github.com/psychobunny	0	3	0	3
rafaelfaria	https://github.com/rafaelfaria	1	0	0	1
rafbermudez	https://github.com/rafbermudez	1	0	0	1
randyzwitch	https://github.com/randyzwitch	1	0	0	1
rdoursenaud	https://github.com/rdoursenaud	0	1	0	1
reactormonk	https://github.com/reactormonk	1	0	0	1
reejosamuel	https://github.com/reejosamuel	1	0	0	1
remomueller	https://github.com/remomueller	4	0	0	4
reteprelief	https://github.com/reteprelief	1	2	1	4
reynardmc22	https://github.com/reynardmc22	1	0	0	1
richardkiss	https://github.com/richardkiss	0	2	0	2
rmdashrf-gh	https://github.com/rmdashrf-gh	1	0	0	1
robertinant	https://github.com/robertinant	0	3	0	3
robertwijas	https://github.com/robertwijas	0	1	0	1
robfletcher	https://github.com/robfletcher	1	0	0	1
robotboy655	https://github.com/robotboy655	0	3	0	3
rodrigopolo	https://github.com/rodrigopolo	1	0	0	1
romaonthego	https://github.com/romaonthego	0	3	0	3
romsearcher	https://github.com/romsearcher	1	0	0	1
rpandey1234	https://github.com/rpandey1234	2	3	0	5
rueckstiess	https://github.com/rueckstiess	4	2	0	6
rurseekatze	https://github.com/rurseekatze	1	0	0	1
rustybailey	https://github.com/rustybailey	1	0	0	1
rvangsgaard	https://github.com/rvangsgaard	1	0	0	1
ryancarlson	https://github.com/ryancarlson	0	1	0	1
ryanstewart	https://github.com/ryanstewart	0	1	0	1
ryanwooten6	https://github.com/ryanwooten6	2	2	0	4
sc0ttkclark	https://github.com/sc0ttkclark	0	16	0	16
scottgarner	https://github.com/scottgarner	0	1	0	1
senhorzinho	https://github.com/senhorzinho	7	3	0	10
sergeylukin	https://github.com/sergeylukin	1	2	0	3
sergiopasra	https://github.com/sergiopasra	1	0	0	1
shaoshuai33	https://github.com/shaoshuai33	0	3	0	3
shuklaalok7	https://github.com/shuklaalok7	1	0	0	1
silentroach	https://github.com/silentroach	1	1	0	2
sjhcockrell	https://github.com/sjhcockrell	2	0	0	2
sjmackenzie	https://github.com/sjmackenzie	2	0	0	2
skorasaurus	https://github.com/skorasaurus	2	0	0	2
slip4stream	https://github.com/slip4stream	1	0	0	1
smartinez87	https://github.com/smartinez87	0	1	0	1
smiggle0404	https://github.com/smiggle0404	1	0	0	1
solarmystic	https://github.com/solarmystic	0	1	0	1
songjiayang	https://github.com/songjiayang	1	1	0	2
springmeyer	https://github.com/springmeyer	3	4	0	7
stefan-kolb	https://github.com/stefan-kolb	1	0	0	1
stephenmuss	https://github.com/stephenmuss	0	2	0	2
stereosteve	https://github.com/stereosteve	0	1	0	1
steveworley	https://github.com/steveworley	1	0	0	1
strongriley	https://github.com/strongriley	1	0	0	1
studentIvan	https://github.com/studentIvan	1	0	0	1
surrealroad	https://github.com/surrealroad	1	1	0	2
tablatronix	https://github.com/tablatronix	0	0	1	1
tangsomnang	https://github.com/tangsomnang	1	0	0	1
tatsuhiro-t	https://github.com/tatsuhiro-t	0	1	1	2
themarkness	https://github.com/themarkness	1	0	0	1
theopolisme	https://github.com/theopolisme	1	1	1	3
thiagodiogo	https://github.com/thiagodiogo	0	1	0	1
thomasmckay	https://github.com/thomasmckay	1	0	0	1
timgalebach	https://github.com/timgalebach	0	1	0	1
timlesallen	https://github.com/timlesallen	1	0	0	1
timwhitlock	https://github.com/timwhitlock	1	1	0	2
tmcallaghan	https://github.com/tmcallaghan	1	0	0	1
toastdriven	https://github.com/toastdriven	0	2	0	2
tomasherman	https://github.com/tomasherman	0	1	0	1
tomrittervg	https://github.com/tomrittervg	1	0	0	1
trestletech	https://github.com/trestletech	0	1	0	1
tsilbermann	https://github.com/tsilbermann	1	0	0	1
tstellanova	https://github.com/tstellanova	0	6	0	6
twaddington	https://github.com/twaddington	1	1	0	2
tylersticka	https://github.com/tylersticka	1	0	0	1
unclecheese	https://github.com/unclecheese	0	2	0	2
utkarsh2012	https://github.com/utkarsh2012	1	0	0	1
uturuncoglu	https://github.com/uturuncoglu	2	0	0	2
uvbeenzaned	https://github.com/uvbeenzaned	1	0	0	1
veritasUnae	https://github.com/veritasUnae	3	2	0	5
victorquinn	https://github.com/victorquinn	1	0	0	1
vincentchan	https://github.com/vincentchan	1	0	0	1
visionmedia	https://github.com/visionmedia	0	4	0	4
vitorhirota	https://github.com/vitorhirota	0	1	0	1
wangchangli	https://github.com/wangchangli	0	7	0	7
wereHamster	https://github.com/wereHamster	1	0	0	1
wiedzmin137	https://github.com/wiedzmin137	1	0	0	1
wonderfulll	https://github.com/wonderfulll	1	0	0	1
xiaoyuxiong	https://github.com/xiaoyuxiong	2	0	0	2
yamanetoshi	https://github.com/yamanetoshi	0	2	0	2
yaneurabeya	https://github.com/yaneurabeya	1	0	0	1
yangchenhui	https://github.com/yangchenhui	0	5	1	6
yobbobanana	https://github.com/yobbobanana	1	0	0	1
yodantauber	https://github.com/yodantauber	3	0	0	3
yoshuawuyts	https://github.com/yoshuawuyts	2	1	0	3
yshollander	https://github.com/yshollander	1	0	0	1
yuki-kimoto	https://github.com/yuki-kimoto	0	1	0	1
zadmarbella	https://github.com/zadmarbella	4	0	0	4
zakyshareef	https://github.com/zakyshareef	1	1	1	3
zanematthew	https://github.com/zanematthew	2	2	0	4
zhaozhiming	https://github.com/zhaozhiming	2	1	0	3
zhuangyitao	https://github.com/zhuangyitao	1	1	0	2
AaronWebster	https://github.com/AaronWebster	1	0	0	1
AdamHolwerda	https://github.com/AdamHolwerda	1	0	0	1
AlexCharlton	https://github.com/AlexCharlton	0	1	0	1
AlexMerser21	https://github.com/AlexMerser21	1	0	0	1
AnodeCathode	https://github.com/AnodeCathode	1	0	0	1
Bananeweizen	https://github.com/Bananeweizen	3	0	0	3
Bariloche123	https://github.com/Bariloche123	6	0	0	6
BaseInfinity	https://github.com/BaseInfinity	1	1	0	2
Bigwebmaster	https://github.com/Bigwebmaster	0	1	0	1
BlythMeister	https://github.com/BlythMeister	2	1	0	3
CarlRosschou	https://github.com/CarlRosschou	1	0	0	1
ChrisPortman	https://github.com/ChrisPortman	1	0	0	1
Corinrypkema	https://github.com/Corinrypkema	3	4	0	7
CovertJaguar	https://github.com/CovertJaguar	0	3	0	3
CryptoManiac	https://github.com/CryptoManiac	1	0	0	1
DanielRedOak	https://github.com/DanielRedOak	1	1	0	2
DarrenNguyen	https://github.com/DarrenNguyen	6	0	0	6
DavidCRivera	https://github.com/DavidCRivera	1	0	0	1
DeanGonzalez	https://github.com/DeanGonzalez	8	0	0	8
DenisPitcher	https://github.com/DenisPitcher	0	1	0	1
Dunkleosteus	https://github.com/Dunkleosteus	0	1	0	1
Echo3ToEcho7	https://github.com/Echo3ToEcho7	0	1	0	1
Fansibubbles	https://github.com/Fansibubbles	1	0	0	1
FelipeCabral	https://github.com/FelipeCabral	1	1	0	2
FelixHansson	https://github.com/FelixHansson	1	1	0	2
Fleshgrinder	https://github.com/Fleshgrinder	0	1	0	1
FredrikNoren	https://github.com/FredrikNoren	0	1	0	1
Gargamel1989	https://github.com/Gargamel1989	19	0	0	19
GeekOnCoffee	https://github.com/GeekOnCoffee	0	1	0	1
GeertLitjens	https://github.com/GeertLitjens	1	0	0	1
GlyphStudios	https://github.com/GlyphStudios	1	0	0	1
HackerManiac	https://github.com/HackerManiac	1	0	0	1
Higginbottom	https://github.com/Higginbottom	1	2	0	3
IbeVanmeenen	https://github.com/IbeVanmeenen	0	5	0	5
JamesMGreene	https://github.com/JamesMGreene	1	0	0	1
JeffBezanson	https://github.com/JeffBezanson	2	0	0	2
JeffJacobson	https://github.com/JeffJacobson	0	1	0	1
JingxuanWang	https://github.com/JingxuanWang	1	0	0	1
JohnSmith-LT	https://github.com/JohnSmith-LT	0	2	0	2
JosephSilber	https://github.com/JosephSilber	1	0	0	1
JpDeathBlade	https://github.com/JpDeathBlade	6	0	0	6
Jscortechini	https://github.com/Jscortechini	1	0	0	1
KartikTalwar	https://github.com/KartikTalwar	0	1	0	1
KernelForbin	https://github.com/KernelForbin	1	0	0	1
KlavsKlavsen	https://github.com/KlavsKlavsen	1	0	0	1
Kosta-Github	https://github.com/Kosta-Github	0	1	0	1
LaurenSims03	https://github.com/LaurenSims03	1	0	0	1
Magnifikator	https://github.com/Magnifikator	1	0	0	1
MarcDiethelm	https://github.com/MarcDiethelm	2	0	0	2
MartinPodval	https://github.com/MartinPodval	1	0	0	1
MattScherzer	https://github.com/MattScherzer	0	1	0	1
MehulChoksey	https://github.com/MehulChoksey	0	3	0	3
Michael2008S	https://github.com/Michael2008S	1	0	0	1
MyfanwyNixon	https://github.com/MyfanwyNixon	3	0	0	3
OndraMaterna	https://github.com/OndraMaterna	1	0	0	1
PaigePonzeka	https://github.com/PaigePonzeka	1	0	0	1
PascalPrecht	https://github.com/PascalPrecht	2	0	0	2
Patrick-Reed	https://github.com/Patrick-Reed	1	0	0	1
Pewpewarrows	https://github.com/Pewpewarrows	1	0	0	1
PirateCoffee	https://github.com/PirateCoffee	1	0	0	1
PreetamJinka	https://github.com/PreetamJinka	1	0	0	1
RakeshKumarV	https://github.com/RakeshKumarV	1	0	0	1
RobinHerbots	https://github.com/RobinHerbots	0	0	1	1
RomanMinenok	https://github.com/RomanMinenok	1	1	0	2
SChamberlain	https://github.com/SChamberlain	1	1	0	2
Serhioromano	https://github.com/Serhioromano	1	0	0	1
ShikiOkasaka	https://github.com/ShikiOkasaka	2	1	0	3
SiamKreative	https://github.com/SiamKreative	1	0	0	1
Skalbaggsmos	https://github.com/Skalbaggsmos	1	0	0	1
SpaceRichard	https://github.com/SpaceRichard	1	0	0	1
StudioNoctis	https://github.com/StudioNoctis	1	1	0	2
SublightLabs	https://github.com/SublightLabs	1	0	0	1
SunflowerZZZ	https://github.com/SunflowerZZZ	1	0	0	1
ThePearlyBum	https://github.com/ThePearlyBum	1	0	0	1
ThomasGirard	https://github.com/ThomasGirard	1	0	0	1
TomSteinberg	https://github.com/TomSteinberg	1	0	0	1
WillemPaling	https://github.com/WillemPaling	0	1	0	1
Wolffenstein	https://github.com/Wolffenstein	0	2	0	2
agentphoenix	https://github.com/agentphoenix	1	0	0	1
alberovalley	https://github.com/alberovalley	5	2	0	7
alexcrichton	https://github.com/alexcrichton	1	2	0	3
alfred-valve	https://github.com/alfred-valve	0	7	0	7
alihassan711	https://github.com/alihassan711	1	0	0	1
analytically	https://github.com/analytically	1	0	0	1
andersonorui	https://github.com/andersonorui	4	5	0	9
angel-manuel	https://github.com/angel-manuel	2	1	0	3
anime4christ	https://github.com/anime4christ	1	0	0	1
anthonybruno	https://github.com/anthonybruno	1	0	0	1
antonzherdev	https://github.com/antonzherdev	0	4	0	4
anupanup2001	https://github.com/anupanup2001	1	2	0	3
anupkejriwal	https://github.com/anupkejriwal	2	1	0	3
architshukla	https://github.com/architshukla	2	2	0	4
arvind-naidu	https://github.com/arvind-naidu	0	1	0	1
aslakknutsen	https://github.com/aslakknutsen	0	1	0	1
atelierabbey	https://github.com/atelierabbey	2	1	0	3
austinhappel	https://github.com/austinhappel	0	1	0	1
avanderhoorn	https://github.com/avanderhoorn	0	5	0	5
axelfontaine	https://github.com/axelfontaine	0	1	0	1
bbodenmiller	https://github.com/bbodenmiller	11	5	0	16
beechboy2000	https://github.com/beechboy2000	1	0	0	1
benwhite1992	https://github.com/benwhite1992	1	0	0	1
bighappyface	https://github.com/bighappyface	0	2	0	2
blakewatters	https://github.com/blakewatters	0	1	0	1
blueleader07	https://github.com/blueleader07	1	1	0	2
borisdamevin	https://github.com/borisdamevin	2	2	0	4
brianherbert	https://github.com/brianherbert	0	1	0	1
brianshumate	https://github.com/brianshumate	1	0	0	1
bruderschaft	https://github.com/bruderschaft	1	0	0	1
brunosmartin	https://github.com/brunosmartin	0	1	0	1
brycejohnson	https://github.com/brycejohnson	1	0	0	1
cameronwhite	https://github.com/cameronwhite	1	0	0	1
carangorango	https://github.com/carangorango	0	1	0	1
carillonator	https://github.com/carillonator	1	0	0	1
carschroeder	https://github.com/carschroeder	1	1	0	2
catamorphism	https://github.com/catamorphism	0	2	0	2
choccybutton	https://github.com/choccybutton	1	0	0	1
chrisblossom	https://github.com/chrisblossom	1	0	0	1
chrisgwerder	https://github.com/chrisgwerder	1	0	0	1
claudiosmweb	https://github.com/claudiosmweb	0	1	0	1
clouddueling	https://github.com/clouddueling	1	0	0	1
codeanticode	https://github.com/codeanticode	0	0	1	1
codemonkey85	https://github.com/codemonkey85	6	5	0	11
countableSet	https://github.com/countableSet	2	0	0	2
cowtowncoder	https://github.com/cowtowncoder	0	4	0	4
crashmaster1	https://github.com/crashmaster1	1	0	0	1
crimsonknave	https://github.com/crimsonknave	9	6	0	15
crustymonkey	https://github.com/crustymonkey	0	1	0	1
damagefilter	https://github.com/damagefilter	0	1	0	1
danieldudzic	https://github.com/danieldudzic	1	1	0	2
danielgroves	https://github.com/danielgroves	1	0	0	1
danieljaouen	https://github.com/danieljaouen	1	0	0	1
dansomething	https://github.com/dansomething	1	0	0	1
daveashworth	https://github.com/daveashworth	0	1	0	1
davetcoleman	https://github.com/davetcoleman	3	0	0	3
david-kennan	https://github.com/david-kennan	1	2	0	3
daviddeutsch	https://github.com/daviddeutsch	0	1	0	1
davidmcclure	https://github.com/davidmcclure	0	1	1	2
davidmoebius	https://github.com/davidmoebius	2	0	0	2
davidw-valve	https://github.com/davidw-valve	0	2	0	2
daydreamqian	https://github.com/daydreamqian	1	0	0	1
deadlyraptor	https://github.com/deadlyraptor	0	1	0	1
deanmalmgren	https://github.com/deanmalmgren	3	0	0	3
degeneration	https://github.com/degeneration	1	0	0	1
divanvisagie	https://github.com/divanvisagie	1	0	0	1
dpbullington	https://github.com/dpbullington	6	5	0	11
dreampursuer	https://github.com/dreampursuer	0	1	0	1
earlNameless	https://github.com/earlNameless	1	0	0	1
eddelbuettel	https://github.com/eddelbuettel	0	1	0	1
eduardogreco	https://github.com/eduardogreco	1	0	0	1
efectokoleos	https://github.com/efectokoleos	0	1	0	1
eightysteele	https://github.com/eightysteele	17	1	0	18
einherjer-uy	https://github.com/einherjer-uy	1	2	0	3
erikhenrique	https://github.com/erikhenrique	9	0	0	9
ferventcoder	https://github.com/ferventcoder	1	1	0	2
fir3pho3nixx	https://github.com/fir3pho3nixx	1	0	0	1
fitrandiddle	https://github.com/fitrandiddle	1	0	0	1
fpietrosanti	https://github.com/fpietrosanti	1	0	0	1
fvanderbiest	https://github.com/fvanderbiest	4	0	0	4
gabipetrovay	https://github.com/gabipetrovay	1	0	0	1
gagan-bansal	https://github.com/gagan-bansal	1	0	0	1
galievruslan	https://github.com/galievruslan	5	0	0	5
georgeOsdDev	https://github.com/georgeOsdDev	2	0	0	2
georgema1982	https://github.com/georgema1982	1	0	0	1
ger-benjamin	https://github.com/ger-benjamin	0	2	0	2
gideondsouza	https://github.com/gideondsouza	1	0	0	1
gideongoldin	https://github.com/gideongoldin	1	0	0	1
githubmonkey	https://github.com/githubmonkey	1	0	0	1
greatestview	https://github.com/greatestview	0	1	0	1
grillorafael	https://github.com/grillorafael	1	0	0	1
grundprinzip	https://github.com/grundprinzip	0	2	0	2
gsamokovarov	https://github.com/gsamokovarov	1	0	0	1
guilherme-pg	https://github.com/guilherme-pg	0	1	0	1
gustavohenke	https://github.com/gustavohenke	1	0	0	1
hackiftekhar	https://github.com/hackiftekhar	3	0	0	3
hellopatrick	https://github.com/hellopatrick	1	0	0	1
heltonritter	https://github.com/heltonritter	2	0	0	2
humanmashine	https://github.com/humanmashine	0	1	0	1
hypeJunction	https://github.com/hypeJunction	0	1	0	1
ianestrachan	https://github.com/ianestrachan	0	1	0	1
imsickofmaps	https://github.com/imsickofmaps	2	0	0	2
internaciulo	https://github.com/internaciulo	1	0	0	1
irodrigo-cds	https://github.com/irodrigo-cds	4	0	0	4
irrelevation	https://github.com/irrelevation	1	0	0	1
jacobbednarz	https://github.com/jacobbednarz	1	0	0	1
jaeandersson	https://github.com/jaeandersson	1	0	0	1
jamesjwarren	https://github.com/jamesjwarren	1	0	0	1
jamiebullock	https://github.com/jamiebullock	0	1	0	1
jasonsanjose	https://github.com/jasonsanjose	0	1	0	1
jcaraballo17	https://github.com/jcaraballo17	0	3	0	3
jeongjaehong	https://github.com/jeongjaehong	0	1	0	1
jerusalemdax	https://github.com/jerusalemdax	1	0	0	1
jessevondoom	https://github.com/jessevondoom	0	1	0	1
jethrolarson	https://github.com/jethrolarson	0	1	0	1
joachimdoerr	https://github.com/joachimdoerr	1	0	0	1
joaofeliperm	https://github.com/joaofeliperm	0	3	0	3
johanneswilm	https://github.com/johanneswilm	0	1	0	1
johnbearzhao	https://github.com/johnbearzhao	1	0	0	1
johnmattsson	https://github.com/johnmattsson	1	0	0	1
jonoberheide	https://github.com/jonoberheide	0	1	0	1
joostkremers	https://github.com/joostkremers	0	1	0	1
jordangidoin	https://github.com/jordangidoin	2	0	0	2
josegonzalez	https://github.com/josegonzalez	0	1	0	1
jtaylor-sfdc	https://github.com/jtaylor-sfdc	0	1	1	2
juliantaylor	https://github.com/juliantaylor	0	1	0	1
justinhelmer	https://github.com/justinhelmer	1	0	0	1
jwahdatehagh	https://github.com/jwahdatehagh	2	0	0	2
jwirfs-brock	https://github.com/jwirfs-brock	1	0	0	1
kanikathapar	https://github.com/kanikathapar	0	7	0	7
kanso-design	https://github.com/kanso-design	1	0	0	1
karolgurecki	https://github.com/karolgurecki	1	0	0	1
katrinschoof	https://github.com/katrinschoof	2	0	0	2
keiranmraine	https://github.com/keiranmraine	1	0	0	1
kekkojoker90	https://github.com/kekkojoker90	1	0	0	1
kevincarlson	https://github.com/kevincarlson	1	0	0	1
kevingranade	https://github.com/kevingranade	1	2	0	3
khaledhassan	https://github.com/khaledhassan	1	0	0	1
lamalamaMark	https://github.com/lamalamaMark	1	0	0	1
lastquestion	https://github.com/lastquestion	1	0	0	1
laurarussell	https://github.com/laurarussell	2	1	0	3
leticiaquino	https://github.com/leticiaquino	1	0	0	1
lilianvanzyl	https://github.com/lilianvanzyl	1	0	0	1
lisavanvliet	https://github.com/lisavanvliet	3	2	0	5
lloydhazlett	https://github.com/lloydhazlett	0	1	0	1
lokidokicoki	https://github.com/lokidokicoki	6	0	0	6
lorenzoriano	https://github.com/lorenzoriano	1	0	0	1
lorianderson	https://github.com/lorianderson	0	1	0	1
lpy834994897	https://github.com/lpy834994897	1	0	0	1
lucasbrendel	https://github.com/lucasbrendel	1	0	0	1
lukaszfiszer	https://github.com/lukaszfiszer	1	1	0	2
madseneqvist	https://github.com/madseneqvist	1	0	0	1
makoto-unity	https://github.com/makoto-unity	0	10	0	10
marco-sorich	https://github.com/marco-sorich	1	0	0	1
marcusfritze	https://github.com/marcusfritze	1	0	0	1
marcuswestin	https://github.com/marcuswestin	1	1	0	2
mariusmandal	https://github.com/mariusmandal	4	1	0	5
markclements	https://github.com/markclements	1	0	0	1
markmossberg	https://github.com/markmossberg	0	2	0	2
markwienands	https://github.com/markwienands	2	0	0	2
martinseener	https://github.com/martinseener	1	0	0	1
matteomelani	https://github.com/matteomelani	0	1	0	1
maxonline101	https://github.com/maxonline101	1	0	0	1
mcmonkey4eva	https://github.com/mcmonkey4eva	0	8	1	9
medadvocacia	https://github.com/medadvocacia	3	0	0	3
michaelrbock	https://github.com/michaelrbock	2	0	0	2
michelbalzer	https://github.com/michelbalzer	1	0	0	1
midnightercz	https://github.com/midnightercz	0	1	0	1
mike-anthony	https://github.com/mike-anthony	2	0	0	2
miketsprague	https://github.com/miketsprague	1	0	0	1
mmisztal1980	https://github.com/mmisztal1980	1	0	0	1
mmmnorthmark	https://github.com/mmmnorthmark	1	0	0	1
morethanreal	https://github.com/morethanreal	1	0	0	1
mrdavidlaing	https://github.com/mrdavidlaing	2	1	0	3
mridulsethia	https://github.com/mridulsethia	1	0	0	1
mvogelgesang	https://github.com/mvogelgesang	2	0	0	2
myronmarston	https://github.com/myronmarston	0	1	0	1
nfitzpatrick	https://github.com/nfitzpatrick	2	0	0	2
ngocdaothanh	https://github.com/ngocdaothanh	4	3	0	7
niallkennedy	https://github.com/niallkennedy	0	1	0	1
nicklockwood	https://github.com/nicklockwood	0	1	0	1
nikomatsakis	https://github.com/nikomatsakis	0	1	0	1
nilesjohnson	https://github.com/nilesjohnson	2	0	0	2
nonnenmacher	https://github.com/nonnenmacher	1	0	0	1
noreenbianca	https://github.com/noreenbianca	1	0	0	1
normanmaurer	https://github.com/normanmaurer	3	2	0	5
olivergierke	https://github.com/olivergierke	1	3	0	4
opensorcerer	https://github.com/opensorcerer	3	0	0	3
ozgebarbaros	https://github.com/ozgebarbaros	1	0	0	1
paulgabronis	https://github.com/paulgabronis	1	0	0	1
perandersson	https://github.com/perandersson	7	0	0	7
peterbourgon	https://github.com/peterbourgon	2	0	0	2
philipwalton	https://github.com/philipwalton	1	0	0	1
phillipCouto	https://github.com/phillipCouto	0	1	0	1
pierreallier	https://github.com/pierreallier	1	0	0	1
potatoattack	https://github.com/potatoattack	1	0	0	1
ptwobrussell	https://github.com/ptwobrussell	0	1	0	1
puentesarrin	https://github.com/puentesarrin	0	2	0	2
purushothamc	https://github.com/purushothamc	1	0	0	1
pvandervelde	https://github.com/pvandervelde	1	0	0	1
pyrotechnick	https://github.com/pyrotechnick	2	0	0	2
rafaelfranca	https://github.com/rafaelfranca	0	1	0	1
rafaelpiresm	https://github.com/rafaelpiresm	0	1	1	2
rakeshmenonv	https://github.com/rakeshmenonv	1	0	0	1
ravinggenius	https://github.com/ravinggenius	1	0	0	1
ravipunjwani	https://github.com/ravipunjwani	1	0	0	1
rem0temeth0d	https://github.com/rem0temeth0d	1	0	0	1
robertpainsi	https://github.com/robertpainsi	1	0	0	1
robertseaton	https://github.com/robertseaton	4	2	0	6
robinbijlani	https://github.com/robinbijlani	1	0	0	1
robtheriault	https://github.com/robtheriault	5	0	0	5
romainberger	https://github.com/romainberger	1	1	0	2
rotatingJazz	https://github.com/rotatingJazz	1	0	0	1
rowanmanning	https://github.com/rowanmanning	1	1	0	2
running-frag	https://github.com/running-frag	1	0	0	1
rvandenberge	https://github.com/rvandenberge	0	1	0	1
ryanbrainard	https://github.com/ryanbrainard	1	0	0	1
ryanmcmorrow	https://github.com/ryanmcmorrow	1	0	0	1
samuelpfchoi	https://github.com/samuelpfchoi	1	0	0	1
samuelsimoes	https://github.com/samuelsimoes	1	2	0	3
sanamaharjan	https://github.com/sanamaharjan	0	1	0	1
sbezborotest	https://github.com/sbezborotest	55	24	13	92
schmittlauch	https://github.com/schmittlauch	1	1	0	2
shaunlee2004	https://github.com/shaunlee2004	1	0	0	1
shepherdwind	https://github.com/shepherdwind	1	0	0	1
sigmavirus24	https://github.com/sigmavirus24	0	1	0	1
silviomoreto	https://github.com/silviomoreto	0	1	0	1
simonmichael	https://github.com/simonmichael	1	0	0	1
sindresorhus	https://github.com/sindresorhus	9	2	0	11
skyhaikuteam	https://github.com/skyhaikuteam	0	1	0	1
smashercosmo	https://github.com/smashercosmo	0	1	0	1
spaceindaver	https://github.com/spaceindaver	0	1	0	1
speedy901990	https://github.com/speedy901990	1	3	0	4
sprungknoedl	https://github.com/sprungknoedl	1	0	0	1
sschwartzman	https://github.com/sschwartzman	0	1	1	2
stefanpenner	https://github.com/stefanpenner	0	1	1	2
stefansaraev	https://github.com/stefansaraev	0	3	0	3
steveklabnik	https://github.com/steveklabnik	2	1	0	3
steveluscher	https://github.com/steveluscher	1	0	0	1
stu-salsbury	https://github.com/stu-salsbury	1	2	0	3
stunjiturner	https://github.com/stunjiturner	1	2	2	5
supersupsite	https://github.com/supersupsite	1	0	0	1
sweetguy0883	https://github.com/sweetguy0883	0	1	1	2
t13735892260	https://github.com/t13735892260	1	0	0	1
tammomueller	https://github.com/tammomueller	0	1	0	1
taylorotwell	https://github.com/taylorotwell	0	2	0	2
terminalmage	https://github.com/terminalmage	0	1	0	1
thanhthang20	https://github.com/thanhthang20	1	0	0	1
therealhappy	https://github.com/therealhappy	0	2	1	3
theskeptical	https://github.com/theskeptical	1	0	0	1
theunraveler	https://github.com/theunraveler	0	1	0	1
thiago-negri	https://github.com/thiago-negri	1	0	0	1
thiagorondon	https://github.com/thiagorondon	2	0	0	2
tigrennatenn	https://github.com/tigrennatenn	1	0	0	1
timvenn20183	https://github.com/timvenn20183	2	3	0	5
tistaharahap	https://github.com/tistaharahap	0	1	0	1
tylerhowarth	https://github.com/tylerhowarth	1	0	0	1
valendesigns	https://github.com/valendesigns	0	2	0	2
vascomfnunes	https://github.com/vascomfnunes	0	1	0	1
vinicius0026	https://github.com/vinicius0026	1	1	0	2
violetzijing	https://github.com/violetzijing	1	0	0	1
vojtabiberle	https://github.com/vojtabiberle	1	1	0	2
w33tmaricich	https://github.com/w33tmaricich	1	1	0	2
warhammerkid	https://github.com/warhammerkid	0	1	0	1
welookwelike	https://github.com/welookwelike	0	1	0	1
williausrohr	https://github.com/williausrohr	1	0	0	1
wormbasehelp	https://github.com/wormbasehelp	1	0	0	1
yanickrochon	https://github.com/yanickrochon	1	0	0	1
yapcheahshen	https://github.com/yapcheahshen	1	0	0	1
yingyangcode	https://github.com/yingyangcode	1	0	0	1
yurydelendik	https://github.com/yurydelendik	1	0	0	1
AlbertBoddema	https://github.com/AlbertBoddema	0	2	0	2
AndreasIgelCC	https://github.com/AndreasIgelCC	1	0	0	1
AndrewMarritt	https://github.com/AndrewMarritt	1	0	0	1
BartVolkaerts	https://github.com/BartVolkaerts	1	0	0	1
BrainGlitch85	https://github.com/BrainGlitch85	1	0	0	1
Chicken-Bones	https://github.com/Chicken-Bones	0	3	0	3
ChrisHahlbeck	https://github.com/ChrisHahlbeck	1	0	0	1
CraigWilliams	https://github.com/CraigWilliams	0	1	0	1
DamianEdwards	https://github.com/DamianEdwards	2	0	0	2
DigitalInBlue	https://github.com/DigitalInBlue	0	1	0	1
EthanMichaels	https://github.com/EthanMichaels	0	2	0	2
EvanTeitelman	https://github.com/EvanTeitelman	0	1	0	1
FenrirUnbound	https://github.com/FenrirUnbound	1	0	0	1
FrancescAlted	https://github.com/FrancescAlted	1	0	0	1
GodPlaysChess	https://github.com/GodPlaysChess	0	1	0	1
GullyAPCBurns	https://github.com/GullyAPCBurns	2	0	0	2
HenningSchulz	https://github.com/HenningSchulz	1	0	0	1
Jacob-Friesen	https://github.com/Jacob-Friesen	2	1	0	3
JaimieMurdock	https://github.com/JaimieMurdock	1	0	0	1
JohnTheDaniel	https://github.com/JohnTheDaniel	1	0	0	1
JonathanReeve	https://github.com/JonathanReeve	2	2	0	4
JustBlackBird	https://github.com/JustBlackBird	1	0	0	1
KaoriMatsuoka	https://github.com/KaoriMatsuoka	1	0	0	1
KindarConrath	https://github.com/KindarConrath	0	1	0	1
LandonSchropp	https://github.com/LandonSchropp	1	0	0	1
LaurentGomila	https://github.com/LaurentGomila	0	1	0	1
ManiacTwister	https://github.com/ManiacTwister	1	0	0	1
MarleenThevar	https://github.com/MarleenThevar	1	0	0	1
Namakemonoism	https://github.com/Namakemonoism	1	0	0	1
NicolasPetton	https://github.com/NicolasPetton	0	3	0	3
NightWhistler	https://github.com/NightWhistler	1	7	0	8
PatrickDeelen	https://github.com/PatrickDeelen	0	1	0	1
PetitPrince13	https://github.com/PetitPrince13	1	0	0	1
QuantumBadger	https://github.com/QuantumBadger	2	0	0	2
RobertBColton	https://github.com/RobertBColton	1	0	0	1
RouganStriker	https://github.com/RouganStriker	23	24	0	47
TheHeisenberg	https://github.com/TheHeisenberg	1	0	0	1
ThiagoMiranda	https://github.com/ThiagoMiranda	1	0	0	1
ThrivingKings	https://github.com/ThrivingKings	0	1	0	1
Tjorriemorrie	https://github.com/Tjorriemorrie	1	0	0	1
WebReflection	https://github.com/WebReflection	0	1	0	1
YorickPeterse	https://github.com/YorickPeterse	0	1	0	1
abrahamsangha	https://github.com/abrahamsangha	0	1	0	1
abritinthebay	https://github.com/abritinthebay	0	16	0	16
adriancervoni	https://github.com/adriancervoni	1	1	0	2
adriancollier	https://github.com/adriancollier	0	10	0	10
akhodakivskiy	https://github.com/akhodakivskiy	0	1	0	1
albertbuchard	https://github.com/albertbuchard	1	0	0	1
alexanderedge	https://github.com/alexanderedge	1	0	0	1
allspiritseve	https://github.com/allspiritseve	0	5	0	5
andersforsell	https://github.com/andersforsell	1	0	0	1
andreascreten	https://github.com/andreascreten	11	1	0	12
andreioprisan	https://github.com/andreioprisan	0	1	0	1
andremedeiros	https://github.com/andremedeiros	0	1	0	1
andrewplummer	https://github.com/andrewplummer	1	1	0	2
andrewsardone	https://github.com/andrewsardone	1	0	0	1
andrewsmedina	https://github.com/andrewsmedina	0	1	0	1
andrewsolomon	https://github.com/andrewsolomon	1	0	0	1
arjentienkamp	https://github.com/arjentienkamp	1	0	0	1
asysarchitect	https://github.com/asysarchitect	1	0	0	1
axelGschaider	https://github.com/axelGschaider	1	0	0	1
benjaminoakes	https://github.com/benjaminoakes	0	1	0	1
benoitchantre	https://github.com/benoitchantre	0	1	0	1
bishopmatthew	https://github.com/bishopmatthew	1	0	0	1
bjornharrtell	https://github.com/bjornharrtell	1	1	0	2
blackpandemic	https://github.com/blackpandemic	6	1	0	7
bluefibonacci	https://github.com/bluefibonacci	6	0	0	6
bobsilverberg	https://github.com/bobsilverberg	1	0	0	1
bogdanpopescu	https://github.com/bogdanpopescu	0	2	0	2
brandoniffert	https://github.com/brandoniffert	1	0	0	1
branflake2267	https://github.com/branflake2267	0	1	0	1
briancavalier	https://github.com/briancavalier	0	1	0	1
bsmith-scribe	https://github.com/bsmith-scribe	1	0	0	1
camdenfullmer	https://github.com/camdenfullmer	3	0	0	3
certainlyakey	https://github.com/certainlyakey	1	0	0	1
chainsawsalad	https://github.com/chainsawsalad	1	4	0	5
charlesjshort	https://github.com/charlesjshort	1	0	0	1
chatthunder40	https://github.com/chatthunder40	1	0	0	1
christhekeele	https://github.com/christhekeele	0	1	0	1
chuck-aka-ben	https://github.com/chuck-aka-ben	1	1	0	2
ciaranmcnulty	https://github.com/ciaranmcnulty	0	1	0	1
codeinthehole	https://github.com/codeinthehole	1	0	0	1
collinvandyck	https://github.com/collinvandyck	0	4	0	4
cristicotovan	https://github.com/cristicotovan	1	1	0	2
crosbymichael	https://github.com/crosbymichael	0	1	0	1
curtisrutland	https://github.com/curtisrutland	2	0	0	2
dabraham02124	https://github.com/dabraham02124	1	0	0	1
dancastellani	https://github.com/dancastellani	0	1	0	1
daniel-menard	https://github.com/daniel-menard	2	1	1	4
danielcorreia	https://github.com/danielcorreia	1	0	0	1
danielwellman	https://github.com/danielwellman	0	1	0	1
dannyaldridge	https://github.com/dannyaldridge	2	0	0	2
darinmorrison	https://github.com/darinmorrison	2	0	0	2
davidChevrier	https://github.com/davidChevrier	0	4	4	8
davidchambers	https://github.com/davidchambers	0	3	0	3
davidmooreppf	https://github.com/davidmooreppf	2	0	0	2
davidpaulsson	https://github.com/davidpaulsson	0	1	0	1
derekcicerone	https://github.com/derekcicerone	0	3	0	3
derhaeuptling	https://github.com/derhaeuptling	1	0	0	1
devinhalladay	https://github.com/devinhalladay	1	0	0	1
dgoldman-ebay	https://github.com/dgoldman-ebay	0	1	0	1
dominicbarnes	https://github.com/dominicbarnes	0	1	0	1
dontcallmedom	https://github.com/dontcallmedom	2	0	0	2
douglatornell	https://github.com/douglatornell	1	0	0	1
drpoovilleorg	https://github.com/drpoovilleorg	1	0	0	1
duelinmarkers	https://github.com/duelinmarkers	1	0	0	1
f-schmitt-zih	https://github.com/f-schmitt-zih	1	1	0	2
feinbergscott	https://github.com/feinbergscott	1	0	0	1
flaviotomazio	https://github.com/flaviotomazio	1	0	0	1
florent-andre	https://github.com/florent-andre	1	43	0	44
florianpaquet	https://github.com/florianpaquet	1	0	0	1
garrettwilkin	https://github.com/garrettwilkin	1	1	0	2
gavanderhoorn	https://github.com/gavanderhoorn	1	0	0	1
gcameron89777	https://github.com/gcameron89777	1	0	0	1
ghochard42six	https://github.com/ghochard42six	0	3	0	3
grahamblevins	https://github.com/grahamblevins	1	0	0	1
hawaiianchimp	https://github.com/hawaiianchimp	4	1	0	5
heatherking45	https://github.com/heatherking45	1	0	0	1
igittigitigit	https://github.com/igittigitigit	1	0	0	1
irrationalfab	https://github.com/irrationalfab	0	1	0	1
jacobandresen	https://github.com/jacobandresen	0	2	0	2
jamesmehorter	https://github.com/jamesmehorter	2	0	0	2
jamesmoriarty	https://github.com/jamesmoriarty	1	1	1	3
jancborchardt	https://github.com/jancborchardt	4	4	0	8
javierbertoli	https://github.com/javierbertoli	0	1	0	1
jcarlosgarcia	https://github.com/jcarlosgarcia	2	0	0	2
jeremydmiller	https://github.com/jeremydmiller	2	3	0	5
jeremykendall	https://github.com/jeremykendall	3	1	0	4
jeromewagener	https://github.com/jeromewagener	0	1	0	1
jessereynolds	https://github.com/jessereynolds	1	0	0	1
jmatostelerik	https://github.com/jmatostelerik	1	0	0	1
johanforssell	https://github.com/johanforssell	1	0	0	1
johnmccutchan	https://github.com/johnmccutchan	0	2	1	3
jonathanbaker	https://github.com/jonathanbaker	1	0	0	1
jonathandavis	https://github.com/jonathandavis	0	6	0	6
jonathanolson	https://github.com/jonathanolson	2	1	0	3
jonschlinkert	https://github.com/jonschlinkert	7	2	0	9
joshuaziering	https://github.com/joshuaziering	1	0	0	1
jsullivanlive	https://github.com/jsullivanlive	1	0	0	1
jubranodesign	https://github.com/jubranodesign	2	2	0	4
justinedelson	https://github.com/justinedelson	4	4	0	8
justinpombrio	https://github.com/justinpombrio	1	0	0	1
justinscheetz	https://github.com/justinscheetz	1	0	0	1
justintadlock	https://github.com/justintadlock	0	1	0	1
kannankarthik	https://github.com/kannankarthik	1	0	0	1
kazu-yamamoto	https://github.com/kazu-yamamoto	3	1	0	4
keithrobinson	https://github.com/keithrobinson	1	1	0	2
kooboo-jifeng	https://github.com/kooboo-jifeng	1	0	0	1
kurtismullins	https://github.com/kurtismullins	1	0	0	1
lev-kuznetsov	https://github.com/lev-kuznetsov	0	3	0	3
louischatriot	https://github.com/louischatriot	0	4	0	4
lufengjian049	https://github.com/lufengjian049	1	0	0	1
mAiNiNfEcTiOn	https://github.com/mAiNiNfEcTiOn	0	1	0	1
mach-mme-stst	https://github.com/mach-mme-stst	1	0	0	1
madskonradsen	https://github.com/madskonradsen	0	1	0	1
mandyzhang-bd	https://github.com/mandyzhang-bd	2	5	0	7
marcomartinez	https://github.com/marcomartinez	1	0	0	1
marcoscaceres	https://github.com/marcoscaceres	0	1	0	1
marcuswhybrow	https://github.com/marcuswhybrow	0	1	0	1
markokruustuk	https://github.com/markokruustuk	36	1	1	38
mateodelnorte	https://github.com/mateodelnorte	2	0	0	2
matthiasbeyer	https://github.com/matthiasbeyer	1	0	0	1
menglert11487	https://github.com/menglert11487	2	1	0	3
mfrederickson	https://github.com/mfrederickson	1	0	0	1
michaelcahill	https://github.com/michaelcahill	1	1	0	2
michaeljoseph	https://github.com/michaeljoseph	2	0	0	2
michaelvillar	https://github.com/michaelvillar	0	2	0	2
micheldejoode	https://github.com/micheldejoode	1	0	0	1
midiotthimble	https://github.com/midiotthimble	1	0	0	1
mobilevisuals	https://github.com/mobilevisuals	1	0	0	1
mujtabachohan	https://github.com/mujtabachohan	2	0	0	2
muriloreinert	https://github.com/muriloreinert	1	1	0	2
mustafaerturk	https://github.com/mustafaerturk	0	1	0	1
n3integration	https://github.com/n3integration	1	0	0	1
nicholas-eden	https://github.com/nicholas-eden	1	1	0	2
nicolas-raoul	https://github.com/nicolas-raoul	1	1	0	2
nootanghimire	https://github.com/nootanghimire	1	0	0	1
notanimposter	https://github.com/notanimposter	0	1	0	1
onderaltintas	https://github.com/onderaltintas	2	0	0	2
onemanstartup	https://github.com/onemanstartup	1	0	0	1
ooprogramador	https://github.com/ooprogramador	1	0	0	1
pablooliveira	https://github.com/pablooliveira	1	0	0	1
peterhellberg	https://github.com/peterhellberg	1	0	0	1
philcockfield	https://github.com/philcockfield	1	0	0	1
phillipberndt	https://github.com/phillipberndt	1	0	0	1
phonglam29305	https://github.com/phonglam29305	0	4	0	4
pieterbeulque	https://github.com/pieterbeulque	1	0	0	1
pjotrsavitski	https://github.com/pjotrsavitski	1	1	0	2
rafael-santos	https://github.com/rafael-santos	3	2	0	5
rduivenvoorde	https://github.com/rduivenvoorde	0	1	0	1
redhatlinux10	https://github.com/redhatlinux10	1	0	0	1
remkoboschker	https://github.com/remkoboschker	0	1	0	1
richard-evans	https://github.com/richard-evans	1	0	0	1
richardpawson	https://github.com/richardpawson	1	0	0	1
richdougherty	https://github.com/richdougherty	1	0	0	1
rodryquintero	https://github.com/rodryquintero	1	0	0	1
rsignell-usgs	https://github.com/rsignell-usgs	1	0	0	1
russellporter	https://github.com/russellporter	6	0	0	6
sagikazarmark	https://github.com/sagikazarmark	2	0	0	2
sayedihashimi	https://github.com/sayedihashimi	0	2	0	2
sbezborotest2	https://github.com/sbezborotest2	14	13	0	27
schnipseljagd	https://github.com/schnipseljagd	0	2	0	2
scottgonzalez	https://github.com/scottgonzalez	0	1	0	1
seamusabshere	https://github.com/seamusabshere	1	0	0	1
seishingithub	https://github.com/seishingithub	1	0	0	1
shallker-wang	https://github.com/shallker-wang	1	0	0	1
shaun-edwards	https://github.com/shaun-edwards	1	1	0	2
sheenagregson	https://github.com/sheenagregson	0	1	0	1
smathermather	https://github.com/smathermather	1	0	0	1
smokingbarrel	https://github.com/smokingbarrel	1	0	0	1
snogglethorpe	https://github.com/snogglethorpe	4	0	0	4
sophiewesslau	https://github.com/sophiewesslau	1	11	0	12
sozonovalexey	https://github.com/sozonovalexey	0	1	1	2
stephendonner	https://github.com/stephendonner	1	0	0	1
stevendlander	https://github.com/stevendlander	1	0	0	1
stevenvergenz	https://github.com/stevenvergenz	0	1	0	1
stijnherreman	https://github.com/stijnherreman	1	0	0	1
stuarthodgson	https://github.com/stuarthodgson	1	1	0	2
stygiansabyss	https://github.com/stygiansabyss	2	0	0	2
tallforasmurf	https://github.com/tallforasmurf	0	3	0	3
tatodelaporte	https://github.com/tatodelaporte	1	0	0	1
tenaciousflea	https://github.com/tenaciousflea	1	0	0	1
thealmightyis	https://github.com/thealmightyis	1	0	0	1
thebigredgeek	https://github.com/thebigredgeek	1	0	0	1
timhostettler	https://github.com/timhostettler	0	1	0	1
tizianarefice	https://github.com/tizianarefice	1	0	0	1
travisjeffery	https://github.com/travisjeffery	0	1	0	1
treilly-nuodb	https://github.com/treilly-nuodb	2	0	0	2
unquietpirate	https://github.com/unquietpirate	1	1	0	2
vigneshwaranr	https://github.com/vigneshwaranr	0	1	0	1
vitorbaptista	https://github.com/vitorbaptista	1	0	0	1
weierophinney	https://github.com/weierophinney	0	1	0	1
wilsonfreitas	https://github.com/wilsonfreitas	4	0	0	4
wintergreen77	https://github.com/wintergreen77	1	0	0	1
xDarkParadisE	https://github.com/xDarkParadisE	1	0	0	1
xiongsongsong	https://github.com/xiongsongsong	1	1	0	2
yatishmehta27	https://github.com/yatishmehta27	0	1	0	1
yuya-takeyama	https://github.com/yuya-takeyama	1	0	0	1
zhouguangming	https://github.com/zhouguangming	1	0	0	1
AUTUpStageTeam	https://github.com/AUTUpStageTeam	0	20	0	20
AZatvornitskiy	https://github.com/AZatvornitskiy	0	2	0	2
AngellusMortis	https://github.com/AngellusMortis	1	0	0	1
BartReymenants	https://github.com/BartReymenants	0	3	0	3
BenjaminKnight	https://github.com/BenjaminKnight	1	0	0	1
ChristianGruen	https://github.com/ChristianGruen	0	1	0	1
ChristianWeyer	https://github.com/ChristianWeyer	2	0	0	2
ClutchTortoise	https://github.com/ClutchTortoise	3	1	0	4
DanielMSchmidt	https://github.com/DanielMSchmidt	2	0	0	2
DannyMoerkerke	https://github.com/DannyMoerkerke	1	0	0	1
DestinationMuc	https://github.com/DestinationMuc	1	0	0	1
DmitryEfimenko	https://github.com/DmitryEfimenko	0	6	1	7
DoodleIncident	https://github.com/DoodleIncident	1	0	0	1
Fairnopoly-API	https://github.com/Fairnopoly-API	1	0	0	1
ForbesLindesay	https://github.com/ForbesLindesay	0	1	0	1
GeraintEdwards	https://github.com/GeraintEdwards	2	0	0	2
Glued2Computer	https://github.com/Glued2Computer	1	0	0	1
Joost-Elements	https://github.com/Joost-Elements	1	0	0	1
MagnusValentin	https://github.com/MagnusValentin	1	0	0	1
MiguelCastillo	https://github.com/MiguelCastillo	0	1	0	1
MinecraftFever	https://github.com/MinecraftFever	2	0	0	2
MiniCodeMonkey	https://github.com/MiniCodeMonkey	2	1	0	3
MitchelLabonte	https://github.com/MitchelLabonte	0	1	0	1
PatrickOsborne	https://github.com/PatrickOsborne	2	0	0	2
RussianPenguin	https://github.com/RussianPenguin	1	0	0	1
StudioDotfiles	https://github.com/StudioDotfiles	1	2	0	3
TimLovellSmith	https://github.com/TimLovellSmith	2	2	0	4
Turntablelover	https://github.com/Turntablelover	1	0	0	1
TurtlesAreCute	https://github.com/TurtlesAreCute	1	0	0	1
WilliamtheChad	https://github.com/WilliamtheChad	1	0	0	1
YukonAppleGeek	https://github.com/YukonAppleGeek	0	1	0	1
Zazie-Lavender	https://github.com/Zazie-Lavender	1	0	0	1
andreareginato	https://github.com/andreareginato	5	0	0	5
andrei-kopytov	https://github.com/andrei-kopytov	0	1	0	1
andrewatfornax	https://github.com/andrewatfornax	2	1	0	3
anselmbradford	https://github.com/anselmbradford	2	0	0	2
antongrigoryev	https://github.com/antongrigoryev	4	0	0	4
antonlindstrom	https://github.com/antonlindstrom	1	0	0	1
arbitraryvalue	https://github.com/arbitraryvalue	1	0	0	1
avantgarde1310	https://github.com/avantgarde1310	1	0	0	1
balaji-chronus	https://github.com/balaji-chronus	1	0	0	1
bjornmeansbear	https://github.com/bjornmeansbear	5	0	0	5
brandon-dacrib	https://github.com/brandon-dacrib	1	0	0	1
brandonmeredyk	https://github.com/brandonmeredyk	1	0	0	1
brandonwillard	https://github.com/brandonwillard	1	1	0	2
bravi-software	https://github.com/bravi-software	1	0	0	1
bryanrasmussen	https://github.com/bryanrasmussen	1	0	0	1
brycehutchings	https://github.com/brycehutchings	1	0	0	1
catskillmarina	https://github.com/catskillmarina	1	0	0	1
chrisballinger	https://github.com/chrisballinger	0	1	0	1
chrisdickinson	https://github.com/chrisdickinson	0	4	0	4
chrismanderson	https://github.com/chrismanderson	1	0	0	1
christianrojas	https://github.com/christianrojas	1	0	0	1
christiansmith	https://github.com/christiansmith	1	1	0	2
commadelimited	https://github.com/commadelimited	0	2	0	2
danielafeitosa	https://github.com/danielafeitosa	4	0	0	4
danielmtavares	https://github.com/danielmtavares	0	1	0	1
danielputerman	https://github.com/danielputerman	1	0	0	1
davidkennedy85	https://github.com/davidkennedy85	1	0	0	1
davidsteinberg	https://github.com/davidsteinberg	1	0	0	1
deniskoronchik	https://github.com/deniskoronchik	1	0	0	1
dgutierrez1287	https://github.com/dgutierrez1287	1	1	0	2
dmitriykuptsov	https://github.com/dmitriykuptsov	1	0	0	1
dmitry-zaitsev	https://github.com/dmitry-zaitsev	0	1	0	1
elbertbautista	https://github.com/elbertbautista	1	1	0	2
ericvaandering	https://github.com/ericvaandering	0	1	0	1
evelynmitchell	https://github.com/evelynmitchell	1	0	0	1
eventualbuddha	https://github.com/eventualbuddha	0	3	0	3
factrealkuwano	https://github.com/factrealkuwano	3	0	0	3
fjuarezmurillo	https://github.com/fjuarezmurillo	3	1	0	4
franciscomoura	https://github.com/franciscomoura	0	1	0	1
francoisfrisch	https://github.com/francoisfrisch	0	1	0	1
frasertweedale	https://github.com/frasertweedale	1	0	0	1
gabrielrinaldi	https://github.com/gabrielrinaldi	1	0	0	1
galanogiuseppe	https://github.com/galanogiuseppe	1	0	0	1
geoffroy-aubry	https://github.com/geoffroy-aubry	2	0	0	2
gergely-ujvari	https://github.com/gergely-ujvari	0	1	0	1
goldsteinmedia	https://github.com/goldsteinmedia	1	0	0	1
gordonwoodhull	https://github.com/gordonwoodhull	1	0	0	1
gumptionthomas	https://github.com/gumptionthomas	1	0	0	1
gustavofonseca	https://github.com/gustavofonseca	2	1	0	3
hamidsfandiari	https://github.com/hamidsfandiari	1	0	0	1
henrywasserman	https://github.com/henrywasserman	1	0	0	1
hisham-elbreky	https://github.com/hisham-elbreky	1	0	0	1
holgersindbaek	https://github.com/holgersindbaek	0	1	0	1
ilya-stromberg	https://github.com/ilya-stromberg	2	0	0	2
indualagarsamy	https://github.com/indualagarsamy	1	0	0	1
innocreativede	https://github.com/innocreativede	1	0	0	1
ivanrodriguez5	https://github.com/ivanrodriguez5	1	0	0	1
jaceklaskowski	https://github.com/jaceklaskowski	1	0	0	1
jamesgillispie	https://github.com/jamesgillispie	1	0	0	1
jeremy-derusse	https://github.com/jeremy-derusse	2	0	0	2
joe-vanleeuwen	https://github.com/joe-vanleeuwen	0	1	0	1
john-orange-aa	https://github.com/john-orange-aa	1	0	0	1
julie-sullivan	https://github.com/julie-sullivan	1	0	0	1
keyboardsurfer	https://github.com/keyboardsurfer	0	1	0	1
kirstenalarsen	https://github.com/kirstenalarsen	4	2	0	6
kolinkrewinkel	https://github.com/kolinkrewinkel	0	1	0	1
kornicameister	https://github.com/kornicameister	1	0	0	1
kristinbranson	https://github.com/kristinbranson	1	0	0	1
kyleabeauchamp	https://github.com/kyleabeauchamp	4	0	0	4
leandromacrini	https://github.com/leandromacrini	1	0	0	1
leandroramosbr	https://github.com/leandroramosbr	1	0	0	1
leonardothibes	https://github.com/leonardothibes	3	0	0	3
lionel-bijaoui	https://github.com/lionel-bijaoui	1	0	0	1
lucavibesmilan	https://github.com/lucavibesmilan	1	0	0	1
mahmoodramzani	https://github.com/mahmoodramzani	0	4	0	4
matthewbaggett	https://github.com/matthewbaggett	3	3	0	6
matthewruttley	https://github.com/matthewruttley	1	0	0	1
michaelficarra	https://github.com/michaelficarra	0	1	0	1
michaelhagedon	https://github.com/michaelhagedon	0	1	0	1
michaelklishin	https://github.com/michaelklishin	3	0	0	3
michaelochurch	https://github.com/michaelochurch	1	0	0	1
michaelwholley	https://github.com/michaelwholley	1	1	0	2
michburkhalter	https://github.com/michburkhalter	3	0	0	3
michielbdejong	https://github.com/michielbdejong	1	1	0	2
morganericsson	https://github.com/morganericsson	0	1	0	1
nachocapodanno	https://github.com/nachocapodanno	1	0	0	1
nariakiiwatani	https://github.com/nariakiiwatani	0	1	0	1
nathanaeljones	https://github.com/nathanaeljones	1	0	0	1
newlandsvalley	https://github.com/newlandsvalley	1	0	0	1
nhatminh123691	https://github.com/nhatminh123691	1	0	0	1
nicolas-grekas	https://github.com/nicolas-grekas	2	0	0	2
nielslelieveld	https://github.com/nielslelieveld	1	0	0	1
notionparallax	https://github.com/notionparallax	9	1	0	10
olivier-stasse	https://github.com/olivier-stasse	0	1	0	1
particlebanana	https://github.com/particlebanana	0	1	0	1
pavel-shvetsov	https://github.com/pavel-shvetsov	1	1	0	2
per-samuelsson	https://github.com/per-samuelsson	2	2	0	4
peter-driscoll	https://github.com/peter-driscoll	1	0	0	1
peter-gribanov	https://github.com/peter-gribanov	3	2	0	5
pierrickrouxel	https://github.com/pierrickrouxel	0	1	0	1
piotrkowalczuk	https://github.com/piotrkowalczuk	1	0	0	1
pippinsplugins	https://github.com/pippinsplugins	1	0	0	1
radicalbiscuit	https://github.com/radicalbiscuit	2	0	0	2
randomfreeform	https://github.com/randomfreeform	2	0	0	2
rasmusbergpalm	https://github.com/rasmusbergpalm	0	1	0	1
responsive-cms	https://github.com/responsive-cms	0	1	0	1
robwierzbowski	https://github.com/robwierzbowski	1	0	0	1
romainfrancois	https://github.com/romainfrancois	0	2	0	2
samuelgruetter	https://github.com/samuelgruetter	1	0	0	1
sattes-faction	https://github.com/sattes-faction	1	0	0	1
saulshanabrook	https://github.com/saulshanabrook	1	0	0	1
spencerfinnell	https://github.com/spencerfinnell	1	0	0	1
sriramkrishnan	https://github.com/sriramkrishnan	0	1	0	1
stephenbrannon	https://github.com/stephenbrannon	0	1	0	1
stevenschobert	https://github.com/stevenschobert	0	1	0	1
sthomas-github	https://github.com/sthomas-github	1	0	0	1
supermarioprof	https://github.com/supermarioprof	1	0	0	1
theburningmonk	https://github.com/theburningmonk	1	3	0	4
themitchuation	https://github.com/themitchuation	1	0	0	1
thomas-moulard	https://github.com/thomas-moulard	1	1	0	2
thomasjbradley	https://github.com/thomasjbradley	0	4	0	4
truonganhhoang	https://github.com/truonganhhoang	12	0	0	12
twistedvisions	https://github.com/twistedvisions	0	1	0	1
twork-veracode	https://github.com/twork-veracode	1	0	0	1
umpitygrumpity	https://github.com/umpitygrumpity	1	0	0	1
vincentbriglia	https://github.com/vincentbriglia	1	0	0	1
zackarychapple	https://github.com/zackarychapple	1	0	0	1
AnotherOneAckap	https://github.com/AnotherOneAckap	0	0	1	1
AnthonyMastrean	https://github.com/AnthonyMastrean	1	5	0	6
AntonDvachevsky	https://github.com/AntonDvachevsky	1	1	0	2
AntonioAngelino	https://github.com/AntonioAngelino	1	0	0	1
DanielleWingler	https://github.com/DanielleWingler	1	0	0	1
GreatArkStudios	https://github.com/GreatArkStudios	1	0	0	1
Henrikwjacobsen	https://github.com/Henrikwjacobsen	1	0	0	1
JessicaBachmann	https://github.com/JessicaBachmann	1	0	0	1
JonathanWiggins	https://github.com/JonathanWiggins	0	1	0	1
JorisLambrechts	https://github.com/JorisLambrechts	0	8	0	8
Joshua-Anderson	https://github.com/Joshua-Anderson	1	0	0	1
JulienChampseix	https://github.com/JulienChampseix	2	0	0	2
LaurentDardenne	https://github.com/LaurentDardenne	1	0	0	1
Mark-E-Hamilton	https://github.com/Mark-E-Hamilton	3	0	0	3
MartinFleischer	https://github.com/MartinFleischer	1	0	0	1
MyRealityCoding	https://github.com/MyRealityCoding	1	0	0	1
OlofFredriksson	https://github.com/OlofFredriksson	1	0	0	1
Paulina-Rosetta	https://github.com/Paulina-Rosetta	1	1	0	2
RedEyedPigStyle	https://github.com/RedEyedPigStyle	1	0	0	1
ScottishSamurai	https://github.com/ScottishSamurai	1	0	0	1
SimonRichardson	https://github.com/SimonRichardson	0	2	0	2
StefanKarpinski	https://github.com/StefanKarpinski	2	0	0	2
Victor-Oliveira	https://github.com/Victor-Oliveira	0	1	0	1
VictorBjelkholm	https://github.com/VictorBjelkholm	2	3	0	5
WarrenWeckesser	https://github.com/WarrenWeckesser	0	1	0	1
WestleyArgentum	https://github.com/WestleyArgentum	1	0	0	1
YellowAfterlife	https://github.com/YellowAfterlife	0	1	0	1
adrianboimvaser	https://github.com/adrianboimvaser	0	1	0	1
alexbaumgertner	https://github.com/alexbaumgertner	6	0	0	6
amitavmohanty01	https://github.com/amitavmohanty01	1	0	0	1
andrewharmellaw	https://github.com/andrewharmellaw	0	1	1	2
andrewkittredge	https://github.com/andrewkittredge	1	0	0	1
andrewmusselman	https://github.com/andrewmusselman	1	0	0	1
anthony-kolesov	https://github.com/anthony-kolesov	0	1	0	1
arthurschreiber	https://github.com/arthurschreiber	0	1	0	1
benjchristensen	https://github.com/benjchristensen	1	0	0	1
bharatbolisetty	https://github.com/bharatbolisetty	1	0	0	1
bootstraponline	https://github.com/bootstraponline	3	7	0	10
braxton-schafer	https://github.com/braxton-schafer	1	0	0	1
brendanzagaeski	https://github.com/brendanzagaeski	1	0	0	1
christian-posta	https://github.com/christian-posta	2	0	0	2
christianklisch	https://github.com/christianklisch	1	1	0	2
colinmollenhour	https://github.com/colinmollenhour	0	1	0	1
collinforrester	https://github.com/collinforrester	1	0	0	1
curioustechizen	https://github.com/curioustechizen	1	0	0	1
daivabrazukaite	https://github.com/daivabrazukaite	5	18	0	23
danielbachhuber	https://github.com/danielbachhuber	0	2	0	2
danielfernandez	https://github.com/danielfernandez	0	1	0	1
davidsteinsland	https://github.com/davidsteinsland	1	0	0	1
davidvanleeuwen	https://github.com/davidvanleeuwen	0	1	0	1
deafbybeheading	https://github.com/deafbybeheading	1	0	0	1
designprofessor	https://github.com/designprofessor	3	2	0	5
doismellburning	https://github.com/doismellburning	1	0	0	1
dotnetCarpenter	https://github.com/dotnetCarpenter	1	0	0	1
eduardolundgren	https://github.com/eduardolundgren	2	2	0	4
edwardhotchkiss	https://github.com/edwardhotchkiss	0	2	0	2
edwardintoronto	https://github.com/edwardintoronto	1	1	0	2
emanuelschuetze	https://github.com/emanuelschuetze	0	1	0	1
emiliodelagarza	https://github.com/emiliodelagarza	0	1	0	1
erikscotjohnson	https://github.com/erikscotjohnson	1	7	1	9
evincarofautumn	https://github.com/evincarofautumn	3	0	0	3
fabriziofortino	https://github.com/fabriziofortino	1	0	0	1
gabrielschulhof	https://github.com/gabrielschulhof	1	0	0	1
grahammcculloch	https://github.com/grahammcculloch	1	4	0	5
guillaumepotier	https://github.com/guillaumepotier	1	0	0	1
hirokiterashima	https://github.com/hirokiterashima	1	3	0	4
hugorodgerbrown	https://github.com/hugorodgerbrown	1	0	0	1
igor-alexandrov	https://github.com/igor-alexandrov	0	1	0	1
igoratencompass	https://github.com/igoratencompass	1	1	0	2
iosappdeveloper	https://github.com/iosappdeveloper	1	0	0	1
ivanacostarubio	https://github.com/ivanacostarubio	1	0	0	1
jacobratkiewicz	https://github.com/jacobratkiewicz	4	0	0	4
jedrzejchalubek	https://github.com/jedrzejchalubek	1	1	0	2
jonathanhaslett	https://github.com/jonathanhaslett	3	0	0	3
joshua-chavanne	https://github.com/joshua-chavanne	1	0	0	1
kelseyhightower	https://github.com/kelseyhightower	6	1	0	7
knowledges33ker	https://github.com/knowledges33ker	0	1	0	1
kyoma-takahashi	https://github.com/kyoma-takahashi	1	0	0	1
legendofscottyb	https://github.com/legendofscottyb	1	0	0	1
lisaglendenning	https://github.com/lisaglendenning	0	1	0	1
manishsongirkar	https://github.com/manishsongirkar	2	0	0	2
manwesulimo2004	https://github.com/manwesulimo2004	1	0	0	1
mariusGundersen	https://github.com/mariusGundersen	1	0	0	1
martinlabuschin	https://github.com/martinlabuschin	12	4	0	16
matheus-fonseca	https://github.com/matheus-fonseca	0	5	0	5
maxime-paquatte	https://github.com/maxime-paquatte	1	1	0	2
mellifiedmonkey	https://github.com/mellifiedmonkey	1	0	0	1
meredevelopment	https://github.com/meredevelopment	1	0	0	1
mhasan2003mitul	https://github.com/mhasan2003mitul	1	1	1	3
michaelmcnamara	https://github.com/michaelmcnamara	1	0	0	1
michelle-becker	https://github.com/michelle-becker	1	0	0	1
miguelrochefort	https://github.com/miguelrochefort	14	0	0	14
mikepetersonccv	https://github.com/mikepetersonccv	1	0	0	1
nader-aeinehchi	https://github.com/nader-aeinehchi	1	0	0	1
neilgilbert1234	https://github.com/neilgilbert1234	1	0	0	1
newsocialifecom	https://github.com/newsocialifecom	1	2	0	3
nikhilgonsalves	https://github.com/nikhilgonsalves	1	0	0	1
nospampleasemam	https://github.com/nospampleasemam	0	1	0	1
olivierthereaux	https://github.com/olivierthereaux	933	38	0	971
pauliusmaciulis	https://github.com/pauliusmaciulis	1	0	0	1
perimosocordiae	https://github.com/perimosocordiae	1	0	0	1
petebacondarwin	https://github.com/petebacondarwin	0	1	0	1
petroniocandido	https://github.com/petroniocandido	0	2	0	2
phillipuniverse	https://github.com/phillipuniverse	3	0	0	3
robertatakenaka	https://github.com/robertatakenaka	1	26	0	27
roberts-sandbox	https://github.com/roberts-sandbox	2	0	0	2
romainguefveneu	https://github.com/romainguefveneu	1	0	0	1
ronnyvieiracruz	https://github.com/ronnyvieiracruz	1	0	0	1
ryanhobsonsmith	https://github.com/ryanhobsonsmith	4	1	0	5
savetheinternet	https://github.com/savetheinternet	0	1	0	1
schwarzaufweiss	https://github.com/schwarzaufweiss	1	0	0	1
shane-tomlinson	https://github.com/shane-tomlinson	2	0	0	2
simonewebdesign	https://github.com/simonewebdesign	1	0	0	1
sledgehammer999	https://github.com/sledgehammer999	0	1	0	1
stephen-swensen	https://github.com/stephen-swensen	1	0	0	1
thegreatmichael	https://github.com/thegreatmichael	1	0	0	1
thelazydogsback	https://github.com/thelazydogsback	0	1	0	1
therealprologic	https://github.com/therealprologic	1	0	0	1
thomas-mcdonald	https://github.com/thomas-mcdonald	0	1	0	1
timrobertson100	https://github.com/timrobertson100	3	2	0	5
unattended-user	https://github.com/unattended-user	1	0	0	1
unknownbrackets	https://github.com/unknownbrackets	0	1	0	1
victorlevasseur	https://github.com/victorlevasseur	3	3	0	6
wachterjohannes	https://github.com/wachterjohannes	0	1	0	1
AmpersandScripts	https://github.com/AmpersandScripts	1	0	0	1
ColonelThirtyTwo	https://github.com/ColonelThirtyTwo	1	0	0	1
FrancoisBergeron	https://github.com/FrancoisBergeron	1	0	0	1
GingerCultLeader	https://github.com/GingerCultLeader	1	0	0	1
PaperDominicPile	https://github.com/PaperDominicPile	1	0	0	1
PercussiveRepair	https://github.com/PercussiveRepair	1	0	0	1
SebastianArnoldt	https://github.com/SebastianArnoldt	1	1	0	2
THWhitelightning	https://github.com/THWhitelightning	1	0	0	1
anxiousmodernman	https://github.com/anxiousmodernman	1	0	0	1
atinder-snippets	https://github.com/atinder-snippets	1	0	0	1
carlrodriguesodi	https://github.com/carlrodriguesodi	1	0	0	1
chorankates-sfdc	https://github.com/chorankates-sfdc	0	1	0	1
deivid-rodriguez	https://github.com/deivid-rodriguez	1	0	0	1
diegomaldonado86	https://github.com/diegomaldonado86	1	0	0	1
gavrilovmiroslav	https://github.com/gavrilovmiroslav	3	0	0	3
git-admin-trulia	https://github.com/git-admin-trulia	39	0	0	39
grayghostvisuals	https://github.com/grayghostvisuals	1	0	0	1
ignacysokolowski	https://github.com/ignacysokolowski	1	0	0	1
infracaninophile	https://github.com/infracaninophile	0	1	0	1
jamesrobertlloyd	https://github.com/jamesrobertlloyd	5	1	0	6
jshraibman-mdsol	https://github.com/jshraibman-mdsol	1	0	0	1
krzysiekpiasecki	https://github.com/krzysiekpiasecki	1	0	0	1
lawrencejohnston	https://github.com/lawrencejohnston	1	0	0	1
marcellustavares	https://github.com/marcellustavares	1	0	0	1
mariana-gheorghe	https://github.com/mariana-gheorghe	1	0	0	1
markmacgillivray	https://github.com/markmacgillivray	3	2	0	5
mauriciopasquier	https://github.com/mauriciopasquier	1	0	0	1
michaelcodehouse	https://github.com/michaelcodehouse	1	0	0	1
michaelflowersky	https://github.com/michaelflowersky	1	0	0	1
michail-nikolaev	https://github.com/michail-nikolaev	3	5	0	8
monkeydagger2013	https://github.com/monkeydagger2013	1	0	0	1
ryancramerdesign	https://github.com/ryancramerdesign	0	3	0	3
sallespromanager	https://github.com/sallespromanager	0	1	0	1
samsung-shv-e160	https://github.com/samsung-shv-e160	0	2	1	3
scott-davidjones	https://github.com/scott-davidjones	1	0	0	1
sergeychernyshev	https://github.com/sergeychernyshev	0	1	0	1
stephanemagnenat	https://github.com/stephanemagnenat	0	2	0	2
technicalcycling	https://github.com/technicalcycling	1	0	0	1
technicalpickles	https://github.com/technicalpickles	1	0	0	1
thirtythreeforty	https://github.com/thirtythreeforty	0	1	0	1
viciousambitious	https://github.com/viciousambitious	1	0	0	1
wikipedia-mabdul	https://github.com/wikipedia-mabdul	0	1	1	2
AdrianArroyoCalle	https://github.com/AdrianArroyoCalle	8	0	0	8
Angelamariewatson	https://github.com/Angelamariewatson	1	0	0	1
BenjaminSmith-cpe	https://github.com/BenjaminSmith-cpe	2	0	0	2
BitMobileCustomer	https://github.com/BitMobileCustomer	1	0	0	1
Kensuke-Mitsuzawa	https://github.com/Kensuke-Mitsuzawa	1	0	0	1
Rahulgupta-cdnsol	https://github.com/Rahulgupta-cdnsol	2	0	0	2
VladimirHavenchyk	https://github.com/VladimirHavenchyk	3	1	0	4
WizardShotTheFood	https://github.com/WizardShotTheFood	1	0	0	1
balandinodidonato	https://github.com/balandinodidonato	1	3	0	4
darren-bridenbeck	https://github.com/darren-bridenbeck	1	0	0	1
eduardoschneiders	https://github.com/eduardoschneiders	3	2	0	5
gallandarakhneorg	https://github.com/gallandarakhneorg	0	1	0	1
hrishikesh-mishra	https://github.com/hrishikesh-mishra	1	0	0	1
james-m-henderson	https://github.com/james-m-henderson	1	0	0	1
jasonandrewduncan	https://github.com/jasonandrewduncan	2	1	0	3
mhohn-hildenbrand	https://github.com/mhohn-hildenbrand	1	1	0	2
michael-heerdegen	https://github.com/michael-heerdegen	1	0	0	1
michaelbrunnbauer	https://github.com/michaelbrunnbauer	1	0	0	1
mikecastrodemaria	https://github.com/mikecastrodemaria	1	0	0	1
newyankeecodeshop	https://github.com/newyankeecodeshop	2	1	0	3
nickolas-pohilets	https://github.com/nickolas-pohilets	1	0	0	1
openscholar-admin	https://github.com/openscholar-admin	2	0	0	2
severin-lemaignan	https://github.com/severin-lemaignan	2	0	0	2
shilpa-narasimhan	https://github.com/shilpa-narasimhan	1	0	0	1
stefan-niedermann	https://github.com/stefan-niedermann	1	0	0	1
tarballs-are-good	https://github.com/tarballs-are-good	1	0	0	1
varanasisaigithub	https://github.com/varanasisaigithub	1	0	0	1
veganstraightedge	https://github.com/veganstraightedge	1	0	0	1
alexanderpanchenko	https://github.com/alexanderpanchenko	0	1	0	1
claytonraymond2004	https://github.com/claytonraymond2004	1	0	0	1
cornflakesuperstar	https://github.com/cornflakesuperstar	0	1	0	1
countless-integers	https://github.com/countless-integers	0	1	0	1
dennisschoenmakers	https://github.com/dennisschoenmakers	1	0	0	1
guillermo-carrasco	https://github.com/guillermo-carrasco	0	1	0	1
highslide-software	https://github.com/highslide-software	0	1	1	2
hoagy-davis-digges	https://github.com/hoagy-davis-digges	1	0	0	1
jorisvandenbossche	https://github.com/jorisvandenbossche	1	0	0	1
leightonhargreaves	https://github.com/leightonhargreaves	0	6	0	6
oforralmesdk12orus	https://github.com/oforralmesdk12orus	2	0	0	2
pommedeterresautee	https://github.com/pommedeterresautee	2	0	0	2
sebastien-villemot	https://github.com/sebastien-villemot	1	0	0	1
stephaneMenerville	https://github.com/stephaneMenerville	2	0	0	2
stephen-montgomery	https://github.com/stephen-montgomery	1	0	0	1
testautomationengr	https://github.com/testautomationengr	1	0	0	1
zengyun-programmer	https://github.com/zengyun-programmer	2	0	0	2
ArchipelCrashReport	https://github.com/ArchipelCrashReport	1	0	0	1
arvindvenkataramani	https://github.com/arvindvenkataramani	1	0	0	1
brodydittemore-eDip	https://github.com/brodydittemore-eDip	0	1	0	1
elan-ev-crashlytics	https://github.com/elan-ev-crashlytics	1	0	0	1
flintcreativestudio	https://github.com/flintcreativestudio	1	0	0	1
guillermoprojaslema	https://github.com/guillermoprojaslema	1	0	0	1
kevincrawfordknight	https://github.com/kevincrawfordknight	0	1	0	1
SurvivalGamesMasters	https://github.com/SurvivalGamesMasters	2	1	0	3
advancedwebdeveloper	https://github.com/advancedwebdeveloper	3	0	0	3
antoniovazquezblanco	https://github.com/antoniovazquezblanco	85	0	0	85
victor-gil-sepulveda	https://github.com/victor-gil-sepulveda	2	0	0	2
JohannesLichtenberger	https://github.com/JohannesLichtenberger	1	0	0	1
nicholas-springstudio	https://github.com/nicholas-springstudio	1	1	0	2
forjin-vpac-innovations	https://github.com/forjin-vpac-innovations	1	0	0	1
